Date,Kind,Model,Max Mode,Input (w/ Cache Write),Input (w/o Cache Write),Cache Read,Output Tokens,Total Tokens,Cost
"2025-09-25T21:49:29.934Z","Included","auto","No","15875","0","29240","285","45400","0.03"
"2025-09-25T21:39:40.771Z","Included","auto","No","14540","229148","146678","10314","400680","0.40"
"2025-09-25T21:07:49.777Z","pro-free-trial","auto","No","730","0","92438","279","93447","0.03"
"2025-09-25T20:55:19.869Z","pro-free-trial","auto","No","86152","0","370790","2536","459478","0.22"
"2025-09-25T20:52:21.465Z","pro-free-trial","auto","No","3466","5792","439730","1978","450966","0.13"
"2025-09-25T20:49:16.388Z","pro-free-trial","auto","No","2054","491","256689","1440","260674","0.08"
"2025-09-25T20:46:32.727Z","pro-free-trial","auto","No","76869","0","173935","992","251796","0.15"
"2025-09-25T20:38:11.020Z","pro-free-trial","auto","No","74381","40094","328789","2824","446088","0.24"
"2025-09-25T20:37:14.932Z","pro-free-trial","auto","No","6039","0","72192","389","78620","0.03"
"2025-09-25T20:28:11.870Z","pro-free-trial","auto","No","154375","36265","734202","6886","931728","0.46"
"2025-09-25T20:13:07.707Z","pro-free-trial","auto","No","88923","14070","1110718","8931","1222642","0.46"
"2025-09-25T20:04:32.953Z","pro-free-trial","auto","No","8315","2095","720587","4814","735811","0.22"
"2025-09-25T19:59:48.769Z","pro-free-trial","auto","No","4896","6030","291294","2655","304875","0.10"
"2025-09-25T19:55:29.333Z","pro-free-trial","auto","No","4094","3835","240999","3218","252146","0.09"
"2025-09-25T19:53:55.456Z","pro-free-trial","auto","No","2994","0","38848","450","42292","0.02"
"2025-09-25T19:49:42.774Z","pro-free-trial","auto","No","3788","0","156604","1332","161724","0.05"
"2025-09-25T19:42:17.001Z","pro-free-trial","auto","No","3091","434","125202","1917","130644","0.05"
"2025-09-25T19:37:09.012Z","pro-free-trial","auto","No","4084","3076","159892","2807","169859","0.07"
"2025-09-25T19:33:37.743Z","pro-free-trial","auto","No","23068","0","93088","1589","117745","0.06"
"2025-09-25T19:26:30.158Z","pro-free-trial","auto","No","16918","80867","123661","10767","232213","0.22"
"2025-09-25T19:22:13.631Z","pro-free-trial","auto","No","3450","0","800994","1048","805492","0.21"
"2025-09-25T19:17:21.746Z","pro-free-trial","auto","No","2290","0","777181","1017","780488","0.20"
"2025-09-25T19:16:27.371Z","pro-free-trial","auto","No","361","0","109895","212","110468","0.03"
"2025-09-25T19:15:25.941Z","pro-free-trial","auto","No","2652","0","216200","655","219507","0.06"
"2025-09-25T19:09:47.939Z","pro-free-trial","auto","No","5811","1972","625596","3238","636617","0.19"
"2025-09-25T19:04:37.390Z","pro-free-trial","auto","No","5886","10072","880626","4046","900630","0.26"
"2025-09-25T19:00:42.122Z","pro-free-trial","auto","No","88458","0","383573","1424","473455","0.22"
"2025-09-25T18:46:21.390Z","pro-free-trial","auto","No","2392","0","365014","1249","368655","0.10"
"2025-09-25T18:42:31.275Z","pro-free-trial","auto","No","5336","0","871894","988","878218","0.23"
"2025-09-25T18:40:34.090Z","pro-free-trial","auto","No","2892","0","332751","839","336482","0.09"
"2025-09-25T18:36:56.455Z","pro-free-trial","auto","No","75009","0","329016","1856","405881","0.19"
"2025-09-25T18:28:11.445Z","pro-free-trial","auto","No","6535","1004","398347","2241","408127","0.12"
"2025-09-25T18:25:36.889Z","pro-free-trial","auto","No","5351","20587","359017","2438","387393","0.14"
"2025-09-25T18:20:46.952Z","pro-free-trial","auto","No","5596","0","334555","3744","343895","0.11"
"2025-09-25T18:18:52.831Z","pro-free-trial","auto","No","1115","18255","63080","1095","83545","0.05"
"2025-09-25T18:06:54.405Z","pro-free-trial","auto","No","63609","0","178589","5584","247782","0.16"
"2025-09-25T18:05:52.015Z","pro-free-trial","auto","No","1624","875","68637","1139","72275","0.03"
"2025-09-25T17:58:15.361Z","pro-free-trial","auto","No","9162","0","242371","5525","257058","0.11"
"2025-09-25T17:56:52.211Z","pro-free-trial","auto","No","3418","14608","40078","726","58830","0.04"
"2025-09-25T17:54:42.223Z","pro-free-trial","auto","No","2656","0","37423","371","40450","0.01"
"2025-09-25T17:53:04.681Z","pro-free-trial","auto","No","1857","11468","35567","1132","50024","0.03"
"2025-09-25T17:38:31.383Z","pro-free-trial","auto","No","41107","89165","740343","16482","887097","0.45"
"2025-09-25T17:37:08.741Z","pro-free-trial","auto","No","94018","0","7110","583","101711","0.12"
"2025-09-25T14:14:14.123Z","pro-free-trial","auto","No","92820","0","296690","4967","394477","0.22"
"2025-09-25T13:55:45.196Z","pro-free-trial","auto","No","81662","0","508829","5384","595875","0.26"
"2025-09-25T13:31:17.542Z","pro-free-trial","auto","No","1822","0","339421","811","342054","0.09"
"2025-09-25T13:23:20.955Z","pro-free-trial","auto","No","13966","0","1589136","3427","1606529","0.44"
"2025-09-25T13:19:30.365Z","pro-free-trial","auto","No","7597","0","436917","1027","445541","0.12"
"2025-09-25T13:18:25.021Z","pro-free-trial","auto","No","38626","0","7110","517","46253","0.05"
"2025-09-25T13:09:32.422Z","pro-free-trial","auto","No","665","0","40582","556","41803","0.01"
"2025-09-25T13:04:46.906Z","Errored, Not Charged","auto","No","33473","0","7110","642","41225","0.05"
"2025-09-24T14:27:37.551Z","pro-free-trial","auto","No","0","30593","45984","2420","78997","0.06"
"2025-09-24T14:13:54.874Z","Errored, Not Charged","auto","No","0","32543","142656","3057","178256","0.09"
"2025-09-24T14:05:50.074Z","pro-free-trial","auto","No","7907","0","449770","2554","460231","0.14"
"2025-09-24T13:53:49.627Z","Errored, Not Charged","auto","No","147557","0","1500946","9719","1658222","0.62"
"2025-09-24T13:47:26.470Z","pro-free-trial","auto","No","8159","0","932890","5224","946273","0.27"
"2025-09-24T13:40:12.715Z","pro-free-trial","auto","No","8066","0","674770","5266","688102","0.21"
"2025-09-24T13:31:34.169Z","pro-free-trial","auto","No","3274","0","1263415","1579","1268268","0.33"
"2025-09-24T13:27:39.146Z","pro-free-trial","auto","No","12640","0","664761","1772","679173","0.19"
"2025-09-24T13:26:47.452Z","Errored, Not Charged","auto","No","568","3192","150681","368","154809","0.04"
"2025-09-24T13:25:28.670Z","pro-free-trial","auto","No","1056","4401","298110","893","304460","0.09"
"2025-09-24T13:23:46.554Z","pro-free-trial","auto","No","1724","1360","366768","634","370486","0.10"
"2025-09-24T13:19:30.664Z","pro-free-trial","auto","No","7471","0","1516320","2314","1526105","0.40"
"2025-09-24T13:16:34.621Z","pro-free-trial","auto","No","3618","0","819600","1235","824453","0.22"
"2025-09-24T13:15:16.148Z","Errored, Not Charged","auto","No","2510","0","538371","645","541526","0.14"
"2025-09-24T13:12:06.801Z","pro-free-trial","auto","No","6391","714","501660","2690","511455","0.15"
"2025-09-24T12:46:08.248Z","Errored, Not Charged","auto","No","159397","0","1104531","26811","1290739","0.64"
"2025-09-24T12:38:55.517Z","pro-free-trial","auto","No","937","0","98289","839","100065","0.03"
"2025-09-24T12:35:36.568Z","pro-free-trial","auto","No","1215","0","97075","831","99121","0.03"
"2025-09-24T12:28:38.541Z","pro-free-trial","auto","No","89943","0","7133","1114","98190","0.12"
"2025-09-24T12:03:53.993Z","pro-free-trial","auto","No","773","0","91187","1031","92991","0.03"
"2025-09-24T11:59:40.718Z","pro-free-trial","auto","No","752","0","90436","570","91758","0.03"
"2025-09-24T11:53:11.136Z","pro-free-trial","auto","No","6240","0","1133011","2408","1141659","0.31"
"2025-09-24T11:50:00.625Z","pro-free-trial","auto","No","77110","0","818930","2838","898878","0.32"
"2025-09-24T09:53:00.415Z","pro-free-trial","auto","No","431","0","74149","287","74867","0.02"
"2025-09-24T09:51:15.807Z","pro-free-trial","auto","No","872","0","147019","330","148221","0.04"
"2025-09-24T09:48:41.883Z","pro-free-trial","auto","No","2394","0","649718","906","653018","0.17"
"2025-09-24T09:44:14.107Z","pro-free-trial","auto","No","2976","520","394435","1622","399553","0.11"
"2025-09-24T09:41:53.958Z","pro-free-trial","auto","No","542","0","67382","529","68453","0.02"
"2025-09-24T09:40:30.971Z","pro-free-trial","auto","No","617","0","66766","399","67782","0.02"
"2025-09-24T09:39:41.602Z","pro-free-trial","auto","No","600","0","66167","476","67243","0.02"
"2025-09-24T09:36:38.243Z","pro-free-trial","auto","No","2192","0","259576","631","262399","0.07"
"2025-09-24T09:35:21.946Z","pro-free-trial","auto","No","1640","0","188796","684","191120","0.05"
"2025-09-24T09:33:48.251Z","pro-free-trial","auto","No","981","0","123553","474","125008","0.03"
"2025-09-24T09:27:41.923Z","pro-free-trial","auto","No","5219","0","354796","4543","364558","0.12"
"2025-09-24T09:22:13.107Z","pro-free-trial","auto","No","8139","0","851850","1654","861643","0.23"
"2025-09-24T09:20:43.562Z","pro-free-trial","auto","No","540","0","47488","311","48339","0.01"
"2025-09-24T09:09:48.512Z","pro-free-trial","auto","No","13015","1036","1576541","3736","1594328","0.43"
"2025-09-24T09:08:28.992Z","pro-free-trial","auto","No","1305","914","168856","778","171853","0.05"
"2025-09-24T09:04:57.941Z","pro-free-trial","auto","No","26106","0","105079","409","131594","0.06"
"2025-09-24T09:01:01.582Z","Errored, Not Charged","auto","No","0","48348","233696","891","282935","0.12"
"2025-09-24T08:52:36.003Z","pro-free-trial","auto","No","0","2139","92320","646","95105","0.03"
"2025-09-24T08:51:28.244Z","pro-free-trial","auto","No","0","86996","7104","248","94348","0.11"
"2025-09-24T00:31:45.545Z","pro-free-trial","auto","No","0","1035","92640","330","94005","0.03"
"2025-09-24T00:29:49.445Z","pro-free-trial","auto","No","0","1177","92160","228","93565","0.03"
"2025-09-24T00:28:31.294Z","pro-free-trial","auto","No","0","1481","91552","207","93240","0.03"
"2025-09-24T00:27:34.514Z","pro-free-trial","auto","No","0","1052","91680","200","92932","0.03"
"2025-09-24T00:26:09.545Z","pro-free-trial","auto","No","0","5274","87008","360","92642","0.03"
"2025-09-24T00:19:30.418Z","pro-free-trial","auto","No","0","1361","89536","186","91083","0.03"
"2025-09-24T00:17:34.772Z","pro-free-trial","auto","No","0","437","90176","183","90796","0.02"
"2025-09-24T00:17:01.827Z","pro-free-trial","auto","No","0","621","89664","232","90517","0.02"
"2025-09-24T00:16:22.787Z","pro-free-trial","auto","No","0","1125","88864","188","90177","0.02"
"2025-09-24T00:15:28.881Z","pro-free-trial","auto","No","0","3056","86720","116","89892","0.03"
"2025-09-24T00:12:49.368Z","pro-free-trial","auto","No","0","8903","80384","391","89678","0.03"
"2025-09-24T00:07:11.780Z","pro-free-trial","auto","No","0","3364","84864","338","88566","0.03"
"2025-09-24T00:05:34.349Z","pro-free-trial","auto","No","0","5318","80768","369","86455","0.03"
"2025-09-23T23:57:13.931Z","pro-free-trial","auto","No","0","14955","1483136","13219","1511310","0.47"
"2025-09-23T23:52:07.171Z","pro-free-trial","auto","No","0","2541","62368","503","65412","0.02"
"2025-09-23T23:49:58.027Z","pro-free-trial","auto","No","0","3500","61408","538","65446","0.02"
"2025-09-23T23:46:17.240Z","pro-free-trial","auto","No","0","4383","312608","808","317799","0.09"
"2025-09-23T23:43:10.252Z","pro-free-trial","auto","No","0","4154","356096","647","360897","0.10"
"2025-09-23T23:39:34.681Z","pro-free-trial","auto","No","0","2732","115072","538","118342","0.04"
"2025-09-23T23:36:52.074Z","pro-free-trial","auto","No","0","3886","284992","392","289270","0.08"
"2025-09-23T23:35:55.765Z","pro-free-trial","auto","No","0","806","112960","433","114199","0.03"
"2025-09-23T23:27:44.695Z","pro-free-trial","auto","No","0","10756","2292000","7389","2310145","0.63"
"2025-09-23T23:24:45.228Z","pro-free-trial","auto","No","0","4055","39648","373","44076","0.02"
"2025-09-23T23:22:19.352Z","pro-free-trial","auto","No","0","2131","40992","440","43563","0.02"
"2025-09-23T23:17:55.557Z","pro-free-trial","auto","No","0","5287","1097248","3665","1106200","0.30"
"2025-09-23T23:15:52.709Z","pro-free-trial","auto","No","0","4429","298624","716","303769","0.08"
"2025-09-23T23:14:24.632Z","pro-free-trial","auto","No","0","2119","61600","318","64037","0.02"
"2025-09-23T23:12:57.280Z","pro-free-trial","auto","No","0","1735","29472","341","31548","0.01"
"2025-09-23T23:11:57.505Z","pro-free-trial","auto","No","0","1090","29568","245","30903","0.01"
"2025-09-23T23:10:04.499Z","pro-free-trial","auto","No","0","5643","196320","1973","203936","0.07"
"2025-09-23T23:03:25.202Z","pro-free-trial","auto","No","0","17314","283584","4509","305407","0.12"
"2025-09-23T22:56:55.209Z","pro-free-trial","auto","No","0","134446","1095360","10282","1240088","0.50"
"2025-09-23T22:55:03.105Z","pro-free-trial","auto","No","0","1002","115520","852","117374","0.04"
"2025-09-23T22:54:19.771Z","pro-free-trial","auto","No","0","1345","114176","839","116360","0.04"
"2025-09-23T22:52:52.320Z","pro-free-trial","auto","No","0","651","113824","876","115351","0.03"
"2025-09-23T22:51:30.684Z","pro-free-trial","auto","No","0","1136","113056","70","114262","0.03"
"2025-09-23T22:50:51.916Z","pro-free-trial","auto","No","0","2102","110432","1497","114031","0.04"
"2025-09-23T22:49:58.459Z","pro-free-trial","auto","No","0","870","110304","1199","112373","0.04"
"2025-09-23T22:48:49.383Z","pro-free-trial","auto","No","0","394","109792","817","111003","0.03"
"2025-09-23T22:45:54.256Z","pro-free-trial","auto","No","0","6236","1915968","2061","1924265","0.50"
"2025-09-23T22:44:28.544Z","pro-free-trial","auto","No","0","2233","510016","560","512809","0.13"
"2025-09-23T22:41:50.188Z","pro-free-trial","auto","No","0","5699","1096576","1153","1103428","0.29"
"2025-09-23T22:38:50.200Z","pro-free-trial","auto","No","0","4073","1260608","1261","1265942","0.33"
"2025-09-23T22:36:56.716Z","pro-free-trial","auto","No","0","3247","846720","991","850958","0.22"
"2025-09-23T22:33:53.209Z","pro-free-trial","auto","No","0","9977","1527552","1952","1539481","0.41"
"2025-09-23T22:32:15.758Z","pro-free-trial","auto","No","0","6909","80448","472","87829","0.03"
"2025-09-23T22:27:13.912Z","pro-free-trial","auto","No","0","6563","1356096","1613","1364272","0.36"
"2025-09-23T22:26:29.295Z","pro-free-trial","auto","No","0","59123","62688","914","122725","0.10"
"2025-09-23T22:14:04.888Z","pro-free-trial","auto","No","0","3607","116311","853","120771","0.04"
"2025-09-23T22:12:17.810Z","pro-free-trial","auto","No","0","1379","318752","343","320474","0.08"
"2025-09-23T22:10:53.539Z","pro-free-trial","auto","No","0","2551","392256","476","395283","0.10"
"2025-09-23T22:10:24.154Z","pro-free-trial","auto","No","0","2346","152544","272","155162","0.04"
"2025-09-23T22:09:54.778Z","pro-free-trial","auto","No","0","3671","72640","265","76576","0.02"
"2025-09-23T22:08:42.345Z","pro-free-trial","auto","No","0","3722","72128","314","76164","0.02"
"2025-09-23T22:06:45.391Z","pro-free-trial","auto","No","0","9086","728320","1701","739107","0.20"
"2025-09-23T22:01:51.618Z","pro-free-trial","auto","No","0","9185","1615200","2592","1626977","0.43"
"2025-09-23T22:00:40.856Z","pro-free-trial","auto","No","0","5219","243040","470","248729","0.07"
"2025-09-23T21:58:59.804Z","pro-free-trial","auto","No","0","6589","54560","355","61504","0.02"
"2025-09-23T21:56:14.559Z","pro-free-trial","auto","No","0","6339","54304","396","61039","0.02"
"2025-09-23T21:52:15.836Z","pro-free-trial","auto","No","0","5583","54464","448","60495","0.02"
"2025-09-23T21:50:20.963Z","pro-free-trial","auto","No","0","5144","54368","400","59912","0.02"
"2025-09-23T21:48:11.358Z","pro-free-trial","auto","No","0","1277","57088","1035","59400","0.02"
"2025-09-23T21:46:35.201Z","pro-free-trial","auto","No","0","2808","55072","378","58258","0.02"
"2025-09-23T21:44:18.283Z","pro-free-trial","auto","No","0","2668","225216","519","228403","0.06"
"2025-09-23T21:40:18.029Z","pro-free-trial","auto","No","0","9456","1225632","4459","1239547","0.34"
"2025-09-23T21:38:41.014Z","pro-free-trial","auto","No","0","8801","269056","620","278477","0.08"
"2025-09-23T21:36:52.539Z","pro-free-trial","auto","No","0","6086","36032","331","42449","0.02"
"2025-09-23T21:32:47.634Z","pro-free-trial","auto","No","0","22916","38624","644","62184","0.04"
"2025-09-23T21:31:08.593Z","pro-free-trial","auto","No","0","1905","39040","233","41178","0.01"
"2025-09-23T21:29:55.569Z","pro-free-trial","auto","No","0","23790","35520","1000","60310","0.04"
"2025-09-23T21:27:27.716Z","pro-free-trial","auto","No","0","9399","255328","1048","265775","0.08"
"2025-09-23T21:25:32.048Z","pro-free-trial","auto","No","0","4322","29088","383","33793","0.01"
"2025-09-23T21:19:54.397Z","pro-free-trial","auto","No","0","172665","871296","12554","1056515","0.51"
"2025-09-23T21:13:34.930Z","pro-free-trial","auto","No","0","4620","458336","597","463553","0.12"
"2025-09-23T21:12:44.621Z","pro-free-trial","auto","No","0","1765","74144","160","76069","0.02"
"2025-09-23T21:11:03.532Z","pro-free-trial","auto","No","0","32324","72416","1016","105756","0.06"
"2025-09-23T21:09:29.418Z","pro-free-trial","auto","No","0","2940","71168","447","74555","0.02"
"2025-09-23T21:08:28.600Z","pro-free-trial","auto","No","0","6370","66560","437","73367","0.03"
"2025-09-23T21:06:14.057Z","pro-free-trial","auto","No","0","27559","44032","595","72186","0.05"
"2025-09-23T20:54:55.568Z","pro-free-trial","auto","No","0","3915","66432","461","70808","0.02"
"2025-09-23T20:52:41.512Z","pro-free-trial","auto","No","0","10677","58496","441","69614","0.03"
"2025-09-23T20:48:45.943Z","pro-free-trial","auto","No","0","12515","55360","545","68420","0.03"
"2025-09-23T20:44:10.529Z","pro-free-trial","auto","No","0","23056","296544","676","320276","0.11"
"2025-09-23T20:34:58.755Z","pro-free-trial","auto","No","0","5201","57120","319","62640","0.02"
"2025-09-23T20:33:04.790Z","pro-free-trial","auto","No","0","2218","59040","328","61586","0.02"
"2025-09-23T20:32:07.087Z","pro-free-trial","auto","No","0","3699","80067","1205","84971","0.03"
"2025-09-23T20:30:21.634Z","pro-free-trial","auto","No","0","24759","56688","970","82417","0.05"
"2025-09-23T20:20:08.308Z","pro-free-trial","auto","No","0","16214","171177","1378","188769","0.07"
"2025-09-23T20:11:55.314Z","pro-free-trial","auto","No","0","14637","500416","1034","516087","0.15"
"2025-09-23T20:08:57.242Z","pro-free-trial","auto","No","0","16483","504704","2491","523678","0.16"
"2025-09-23T19:58:42.385Z","pro-free-trial","auto","No","0","123236","858944","18988","1001168","0.48"
"2025-09-23T19:54:19.068Z","pro-free-trial","auto","No","0","11827","1250144","1531","1263502","0.34"
"2025-09-23T19:51:21.430Z","pro-free-trial","auto","No","0","11331","773888","645","785864","0.21"
"2025-09-23T19:46:46.259Z","pro-free-trial","auto","No","0","5523","435424","704","441651","0.12"
"2025-09-23T19:44:41.538Z","pro-free-trial","auto","No","0","4753","319008","1413","325174","0.09"
"2025-09-23T19:42:39.049Z","pro-free-trial","auto","No","0","3783","311200","1142","316125","0.09"
"2025-09-23T19:41:09.634Z","pro-free-trial","auto","No","0","960","204480","477","205917","0.06"
"2025-09-23T19:40:25.459Z","pro-free-trial","auto","No","0","1966","201600","498","204064","0.06"
"2025-09-23T19:38:52.614Z","pro-free-trial","auto","No","0","3627","699872","548","704047","0.18"
"2025-09-23T19:37:26.442Z","pro-free-trial","auto","No","0","3747","294176","422","298345","0.08"
"2025-09-23T19:36:54.118Z","pro-free-trial","auto","No","0","3038","95520","267","98825","0.03"
"2025-09-23T19:34:32.821Z","pro-free-trial","auto","No","0","13184","572160","728","586072","0.16"
"2025-09-23T19:30:53.768Z","pro-free-trial","auto","No","0","6218","279392","1141","286751","0.08"
"2025-09-23T19:29:06.002Z","pro-free-trial","auto","No","0","5266","273536","519","279321","0.08"
"2025-09-23T19:27:24.578Z","pro-free-trial","auto","No","0","9682","522016","1209","532907","0.15"
"2025-09-23T19:23:57.577Z","pro-free-trial","auto","No","0","21268","1157824","9781","1188873","0.37"
"2025-09-23T19:20:26.609Z","pro-free-trial","auto","No","0","4995","129472","395","134862","0.04"
"2025-09-23T19:14:01.071Z","pro-free-trial","auto","No","0","60059","1979040","16244","2055343","0.67"
"2025-09-23T18:48:31.418Z","pro-free-trial","auto","No","50702","0","2517199","20097","2587998","0.81"
"2025-09-23T18:45:36.116Z","pro-free-trial","auto","No","17797","0","240567","1320","259684","0.09"
"2025-09-23T18:32:58.366Z","pro-free-trial","auto","No","1249","0","19844","187","21280","0.01"
"2025-09-23T18:31:18.917Z","pro-free-trial","auto","No","1835","0","37472","345","39652","0.01"
"2025-09-23T18:28:41.786Z","pro-free-trial","auto","No","10613","98876","25035","6694","141218","0.18"
"2025-09-23T18:27:03.699Z","pro-free-trial","auto","No","2319","0","228593","304","231216","0.06"
"2025-09-23T18:24:58.652Z","pro-free-trial","auto","No","106224","0","119858","579","226661","0.17"
"2025-09-23T18:18:18.639Z","pro-free-trial","auto","No","3855","0","984182","1373","989410","0.26"
"2025-09-23T18:15:51.266Z","pro-free-trial","auto","No","3523","0","631362","1219","636104","0.17"
"2025-09-23T18:10:28.724Z","pro-free-trial","auto","No","6057","32327","509170","1554","549108","0.18"
"2025-09-23T18:06:10.293Z","pro-free-trial","auto","No","3789","0","876661","1613","882063","0.23"
"2025-09-23T18:03:46.392Z","pro-free-trial","auto","No","3052","0","469337","912","473301","0.13"
"2025-09-23T18:02:19.455Z","pro-free-trial","auto","No","1616","0","182399","671","184686","0.05"
"2025-09-23T17:59:39.727Z","pro-free-trial","auto","No","4355","0","529733","1339","535427","0.15"
"2025-09-23T17:58:05.716Z","pro-free-trial","auto","No","2423","0","254518","839","257780","0.07"
"2025-09-23T17:56:28.965Z","pro-free-trial","auto","No","4724","0","656405","1297","662426","0.18"
"2025-09-23T17:53:03.698Z","pro-free-trial","auto","No","2217","0","156025","306","158548","0.04"
"2025-09-23T17:50:33.967Z","pro-free-trial","auto","No","2363","21409","151207","1236","176215","0.07"
"2025-09-23T17:49:33.724Z","pro-free-trial","auto","No","2122","0","146894","360","149376","0.04"
"2025-09-23T17:47:31.916Z","pro-free-trial","auto","No","2101","0","142685","289","145075","0.04"
"2025-09-23T17:46:00.982Z","pro-free-trial","auto","No","1351","0","209154","397","210902","0.06"
"2025-09-23T17:44:56.746Z","pro-free-trial","auto","No","1158","0","136742","259","138159","0.04"
"2025-09-23T17:44:08.504Z","pro-free-trial","auto","No","1055","0","134583","281","135919","0.04"
"2025-09-23T17:43:03.673Z","pro-free-trial","auto","No","2307","0","131228","249","133784","0.04"
"2025-09-23T17:41:32.443Z","pro-free-trial","auto","No","2332","15876","126530","1178","145916","0.06"
"2025-09-23T17:39:53.777Z","pro-free-trial","auto","No","2180","0","121946","385","124511","0.04"
"2025-09-23T17:38:53.248Z","pro-free-trial","auto","No","2158","0","117710","323","120191","0.03"
"2025-09-23T17:37:15.357Z","pro-free-trial","auto","No","1636","0","113920","297","115853","0.03"
"2025-09-23T17:35:29.945Z","pro-free-trial","auto","No","1675","0","110631","298","112604","0.03"
"2025-09-23T17:33:47.595Z","pro-free-trial","auto","No","2807","11142","105625","1408","120982","0.05"
"2025-09-23T17:32:22.282Z","pro-free-trial","auto","No","2384","0","100532","638","103554","0.03"
"2025-09-23T17:31:29.993Z","pro-free-trial","auto","No","1721","0","145755","424","147900","0.04"
"2025-09-23T17:30:45.192Z","pro-free-trial","auto","No","2448","0","92495","444","95387","0.03"
"2025-09-23T17:27:39.514Z","pro-free-trial","auto","No","1524","0","88748","359","90631","0.03"
"2025-09-23T17:25:48.599Z","pro-free-trial","auto","No","3854","0","211611","1118","216583","0.06"
"2025-09-23T17:21:33.971Z","pro-free-trial","auto","No","32840","0","442088","4775","479703","0.18"
"2025-09-23T17:13:37.690Z","pro-free-trial","auto","No","0","13022","764288","3362","780672","0.23"
"2025-09-23T17:10:36.763Z","pro-free-trial","auto","No","0","11484","792608","1966","806058","0.22"
"2025-09-23T17:08:01.215Z","pro-free-trial","auto","No","0","10137","256064","1712","267913","0.09"
"2025-09-23T17:03:56.957Z","pro-free-trial","auto","No","0","19432","620064","3405","642901","0.20"
"2025-09-23T16:58:33.385Z","pro-free-trial","auto","No","0","3884","120896","321","125101","0.04"
"2025-09-23T16:56:30.623Z","pro-free-trial","auto","No","0","33692","424096","2834","460622","0.17"
"2025-09-23T13:52:21.700Z","pro-free-trial","auto","No","0","111854","49728","4466","166048","0.18"
"2025-09-23T13:46:23.031Z","pro-free-trial","auto","No","0","5138","336128","3551","344817","0.11"
"2025-09-23T13:44:35.054Z","pro-free-trial","auto","No","0","22679","196576","1236","220491","0.08"
"2025-09-23T13:41:31.417Z","pro-free-trial","auto","No","0","11667","397504","1043","410214","0.12"
"2025-09-23T13:38:39.264Z","pro-free-trial","auto","No","0","14996","1156704","2500","1174200","0.32"
"2025-09-23T13:35:24.497Z","pro-free-trial","auto","No","0","13656","444064","1420","459140","0.14"
"2025-09-23T13:32:16.051Z","pro-free-trial","auto","No","0","10401","427200","1149","438750","0.13"
"2025-09-23T13:29:12.076Z","pro-free-trial","auto","No","0","11807","490368","947","503122","0.14"
"2025-09-23T13:26:37.743Z","pro-free-trial","auto","No","0","8212","156192","483","164887","0.05"
"2025-09-23T13:24:40.085Z","pro-free-trial","auto","No","0","8723","230560","908","240191","0.07"
"2025-09-23T13:22:28.955Z","pro-free-trial","auto","No","0","13701","367648","1064","382413","0.12"
"2025-09-23T13:20:03.670Z","pro-free-trial","auto","No","0","16935","344064","1353","362352","0.12"
"2025-09-23T13:16:38.753Z","pro-free-trial","auto","No","0","5530","201152","245","206927","0.06"
"2025-09-23T13:14:42.558Z","pro-free-trial","auto","No","0","4747","130656","230","135633","0.04"
"2025-09-23T13:13:27.803Z","pro-free-trial","auto","No","0","12073","185984","642","198699","0.07"
"2025-09-23T13:11:14.067Z","pro-free-trial","auto","No","0","11828","300288","1009","313125","0.10"
"2025-09-23T13:08:41.342Z","pro-free-trial","auto","No","0","15316","162496","893","178705","0.07"
"2025-09-23T13:05:56.516Z","pro-free-trial","auto","No","0","7183","213696","1092","221971","0.07"
"2025-09-23T13:03:23.849Z","pro-free-trial","auto","No","0","21801","132320","2792","156913","0.08"
"2025-09-23T13:02:21.881Z","pro-free-trial","auto","No","0","3200","82400","128","85728","0.03"
"2025-09-23T13:01:21.521Z","pro-free-trial","auto","No","0","34903","48480","225","83608","0.06"
"2025-09-23T12:55:31.290Z","pro-free-trial","auto","No","0","31263","354432","13508","399203","0.21"
"2025-09-23T12:52:35.845Z","pro-free-trial","auto","No","0","0","0","0","0","0.00"
"2025-09-23T12:30:17.483Z","pro-free-trial","auto","No","0","166805","857536","766","1025107","0.43"
"2025-09-22T21:58:07.882Z","pro-free-trial","auto","No","3206","25255","445833","2375","476669","0.16"
"2025-09-22T21:56:51.995Z","pro-free-trial","auto","No","1902","0","434355","908","437165","0.12"
"2025-09-22T21:54:39.403Z","pro-free-trial","auto","No","3301","0","636894","1298","641493","0.17"
"2025-09-22T21:52:41.681Z","pro-free-trial","auto","No","3173","0","617651","1236","622060","0.17"
"2025-09-22T21:46:32.811Z","pro-free-trial","auto","No","3141","0","896087","1319","900547","0.24"
"2025-09-22T21:44:32.118Z","pro-free-trial","auto","No","2596","0","581740","728","585064","0.15"
"2025-09-22T21:41:42.636Z","pro-free-trial","auto","No","5342","0","744473","882","750697","0.20"
"2025-09-22T21:31:40.773Z","pro-free-trial","auto","No","2123","0","535616","623","538362","0.14"
"2025-09-22T21:17:15.570Z","pro-free-trial","auto","No","9178","0","997149","1423","1007750","0.27"
"2025-09-22T21:06:19.400Z","pro-free-trial","auto","No","11552","548","597442","1543","611085","0.17"
"2025-09-22T21:04:08.025Z","pro-free-trial","auto","No","61436","0","274782","687","336905","0.15"
"2025-09-22T20:57:43.239Z","pro-free-trial","auto","No","24748","0","1209985","15422","1250155","0.43"
"2025-09-22T20:55:22.775Z","pro-free-trial","auto","No","34251","0","155656","2042","191949","0.09"
"2025-09-22T20:18:26.276Z","pro-free-trial","auto","No","0","0","0","0","0","0.00"
"2025-09-22T20:15:24.151Z","pro-free-trial","auto","No","13366","0","138213","7686","159265","0.10"
"2025-09-22T20:14:54.440Z","pro-free-trial","auto","No","0","0","0","0","0","0.00"
"2025-09-22T20:13:51.227Z","pro-free-trial","auto","No","618","0","50078","202","50898","0.01"
"2025-09-22T20:12:04.434Z","pro-free-trial","auto","No","3550","0","90169","2811","96530","0.04"
"2025-09-22T20:08:28.338Z","Errored, Not Charged","auto","No","9299","0","77718","3978","90995","0.05"
"2025-09-22T20:07:04.798Z","pro-free-trial","auto","No","1406","0","55275","850","57531","0.02"
"2025-09-22T20:06:09.496Z","pro-free-trial","auto","No","2270","0","45620","1242","49132","0.02"
"2025-09-22T20:04:31.423Z","pro-free-trial","auto","No","1088","0","7112","375","8575","0.01"
"2025-09-22T20:04:15.031Z","pro-free-trial","auto","No","0","0","0","0","0","0.00"
"2025-09-22T20:03:03.010Z","pro-free-trial","auto","No","0","0","0","0","0","0.00"
"2025-09-22T20:02:17.638Z","pro-free-trial","auto","No","0","0","0","0","0","0.00"
"2025-09-22T19:59:12.568Z","pro-free-trial","auto","No","0","0","0","0","0","0.00"
"2025-09-22T19:58:45.804Z","pro-free-trial","auto","No","0","0","0","0","0","0.00"
"2025-09-22T19:58:24.828Z","pro-free-trial","auto","No","0","0","0","0","0","0.00"
"2025-09-22T19:57:38.091Z","pro-free-trial","auto","No","0","0","0","0","0","0.00"
"2025-09-22T19:56:51.160Z","pro-free-trial","auto","No","0","0","0","0","0","0.00"
"2025-09-22T19:56:37.701Z","pro-free-trial","auto","No","0","0","0","0","0","0.00"
"2025-09-22T19:56:23.023Z","pro-free-trial","auto","No","0","0","0","0","0","0.00"
"2025-09-22T19:56:02.996Z","pro-free-trial","auto","No","0","0","0","0","0","0.00"
"2025-09-22T19:54:47.762Z","pro-free-trial","auto","No","0","0","0","0","0","0.00"
"2025-09-22T19:53:29.510Z","pro-free-trial","auto","No","5689","0","605410","451","611550","0.16"
"2025-09-22T19:52:01.653Z","pro-free-trial","auto","No","5778","0","157102","449","163329","0.05"
"2025-09-22T19:51:29.636Z","pro-free-trial","auto","No","4710","0","71470","257","76437","0.03"
"2025-09-22T19:50:30.044Z","pro-free-trial","auto","No","6069","0","205972","427","212468","0.06"
"2025-09-22T19:49:29.373Z","pro-free-trial","auto","No","4538","0","60867","233","65638","0.02"
"2025-09-22T19:47:46.322Z","pro-free-trial","auto","No","5906","0","354548","705","361159","0.10"
"2025-09-22T19:43:03.305Z","pro-free-trial","auto","No","7747","0","475066","2128","484941","0.14"
"2025-09-22T19:37:28.954Z","pro-free-trial","auto","No","3346","0","90801","172","94319","0.03"
"2025-09-22T19:36:25.243Z","pro-free-trial","auto","No","9832","0","115243","247","125322","0.04"
"2025-09-22T19:33:52.115Z","pro-free-trial","auto","No","2637","0","65219","158","68014","0.02"
"2025-09-22T19:32:49.816Z","pro-free-trial","auto","No","6936","0","81750","183","88869","0.03"
"2025-09-22T19:31:11.507Z","pro-free-trial","auto","No","2292","215","88838","953","92298","0.03"
"2025-09-22T19:29:48.962Z","pro-free-trial","auto","No","1109","0","42874","141","44124","0.01"
"2025-09-22T19:29:04.282Z","pro-free-trial","auto","No","13981","0","26943","861","41785","0.03"
"2025-09-22T19:26:14.344Z","pro-free-trial","auto","No","461","0","37438","193","38092","0.01"
"2025-09-22T19:20:13.924Z","Errored, Not Charged","auto","No","11553","0","335974","2538","350065","0.11"
"2025-09-22T19:13:32.952Z","Errored, Not Charged","auto","No","0","0","0","0","0","0.00"
"2025-09-22T19:10:33.629Z","Errored, Not Charged","auto","No","22307","0","42656","174","65137","0.04"
"2025-09-22T19:07:46.097Z","pro-free-trial","auto","No","3115","0","1147065","1196","1151376","0.30"
"2025-09-22T19:05:26.310Z","pro-free-trial","auto","No","1354","0","224981","331","226666","0.06"
"2025-09-22T19:02:28.431Z","pro-free-trial","auto","No","426","0","111570","154","112150","0.03"
"2025-09-22T18:59:52.405Z","pro-free-trial","auto","No","3347","0","549018","1268","553633","0.15"
"2025-09-22T18:55:30.318Z","pro-free-trial","auto","No","3332","0","426230","865","430427","0.12"
"2025-09-22T18:48:12.959Z","pro-free-trial","auto","No","7622","0","1925083","2587","1935292","0.51"
"2025-09-22T18:45:27.848Z","pro-free-trial","auto","No","1297","0","482576","588","484461","0.13"
"2025-09-22T18:43:07.848Z","pro-free-trial","auto","No","1849","0","284760","535","287144","0.08"
"2025-09-22T18:39:16.533Z","pro-free-trial","auto","No","4081","0","735296","1434","740811","0.20"
"2025-09-22T18:37:46.828Z","pro-free-trial","auto","No","1987","0","266707","513","269207","0.07"
"2025-09-22T18:35:29.365Z","pro-free-trial","auto","No","1856","0","349042","410","351308","0.09"
"2025-09-22T18:32:31.816Z","pro-free-trial","auto","No","1524","0","426500","699","428723","0.11"
"2025-09-22T18:29:35.619Z","pro-free-trial","auto","No","934","0","168192","280","169406","0.04"
"2025-09-22T18:28:16.371Z","pro-free-trial","auto","No","1721","0","248032","732","250485","0.07"
"2025-09-22T18:26:25.366Z","pro-free-trial","auto","No","74975","0","248812","789","324576","0.16"
"2025-09-22T18:22:47.503Z","pro-free-trial","auto","No","1761","0","233036","664","235461","0.06"
"2025-09-22T18:20:18.907Z","pro-free-trial","auto","No","1402","0","228611","482","230495","0.06"
"2025-09-22T18:18:49.364Z","pro-free-trial","auto","No","1552","0","224269","489","226310","0.06"
"2025-09-22T18:16:54.946Z","pro-free-trial","auto","No","66976","0","154200","489","221665","0.13"
"2025-09-22T17:32:01.058Z","pro-free-trial","auto","No","5768","44412","210974","1120","262274","0.12"
"2025-09-22T17:29:18.048Z","pro-free-trial","auto","No","63112","43605","329014","2104","437835","0.23"
"2025-09-22T17:26:17.671Z","pro-free-trial","auto","No","59751","0","138837","863","199451","0.11"
"2025-09-22T17:23:10.707Z","pro-free-trial","auto","No","2776","0","378711","1344","382831","0.11"
"2025-09-22T17:20:07.247Z","pro-free-trial","auto","No","1760","0","245043","629","247432","0.07"
"2025-09-22T17:16:40.980Z","pro-free-trial","auto","No","5894","0","347320","1259","354473","0.10"
"2025-09-22T17:01:12.373Z","Errored, Not Charged","auto","No","51559","0","3068313","8890","3128762","0.88"
"2025-09-22T16:57:51.904Z","pro-free-trial","auto","No","332","0","109018","219","109569","0.03"
"2025-09-22T16:56:03.225Z","pro-free-trial","auto","No","544","0","108475","184","109203","0.03"
"2025-09-22T16:54:26.314Z","pro-free-trial","auto","No","532","0","107944","409","108885","0.03"
"2025-09-22T16:53:03.964Z","pro-free-trial","auto","No","1285","0","106660","386","108331","0.03"
"2025-09-22T16:45:16.904Z","pro-free-trial","auto","No","9075","0","2228712","6613","2244400","0.61"
"2025-09-22T16:40:38.286Z","pro-free-trial","auto","No","724","0","96884","601","98209","0.03"
"2025-09-22T16:37:53.332Z","pro-free-trial","auto","No","3461","0","858855","2004","864320","0.23"
"2025-09-22T16:33:28.511Z","pro-free-trial","auto","No","5852","0","356793","3987","366632","0.12"
"2025-09-22T16:27:25.686Z","pro-free-trial","auto","No","4205","0","515035","1194","520434","0.14"
"2025-09-22T16:25:30.455Z","pro-free-trial","auto","No","76454","0","172475","620","249549","0.14"
"2025-09-22T14:45:20.536Z","pro-free-trial","auto","No","3650","41663","240170","1689","287172","0.13"
"2025-09-22T14:41:42.524Z","pro-free-trial","auto","No","74059","0","310420","1119","385598","0.18"
"2025-09-22T14:38:03.886Z","pro-free-trial","auto","No","5827","0","713671","1260","720758","0.19"
"2025-09-22T14:36:09.203Z","pro-free-trial","auto","No","3072","36717","132819","1398","174006","0.09"
"2025-09-22T14:26:48.487Z","pro-free-trial","auto","No","17497","0","1120219","8944","1146660","0.36"
"2025-09-22T14:25:51.780Z","pro-free-trial","auto","No","515","0","47205","365","48085","0.01"
"2025-09-22T14:24:23.053Z","pro-free-trial","auto","No","396","0","46810","390","47596","0.01"
"2025-09-22T14:21:39.558Z","pro-free-trial","auto","No","2179","0","136592","760","139531","0.04"
"2025-09-22T14:19:40.544Z","pro-free-trial","auto","No","3975","0","256886","926","261787","0.07"
"2025-09-22T14:17:23.902Z","pro-free-trial","auto","No","3167","0","157022","579","160768","0.05"
"2025-09-22T14:13:38.299Z","pro-free-trial","auto","No","3955","0","404435","1292","409682","0.11"
"2025-09-22T14:11:34.144Z","pro-free-trial","auto","No","1756","26116","100509","1096","129477","0.07"
"2025-09-22T14:10:07.106Z","pro-free-trial","auto","No","2072","25792","127349","1505","156718","0.08"
"2025-09-22T14:05:04.524Z","Errored, Not Charged","auto","No","22793","0","476060","964","499817","0.15"
"2025-09-22T14:02:01.567Z","pro-free-trial","auto","No","1765","0","459636","625","462026","0.12"
"2025-09-22T13:59:40.205Z","pro-free-trial","auto","No","4521","0","673965","1154","679640","0.18"
"2025-09-22T13:55:30.288Z","pro-free-trial","auto","No","6930","0","529298","3005","539233","0.16"
"2025-09-22T13:52:50.059Z","pro-free-trial","auto","No","1879","0","203007","675","205561","0.06"
"2025-09-22T13:49:40.533Z","pro-free-trial","auto","No","6431","0","685234","2893","694558","0.20"
"2025-09-22T13:41:59.977Z","pro-free-trial","auto","No","87446","0","1363603","1810","1452859","0.46"
"2025-09-22T13:39:01.173Z","pro-free-trial","auto","No","78185","0","343552","1886","423623","0.19"
"2025-09-22T13:36:32.244Z","pro-free-trial","auto","No","3131","0","237260","949","241340","0.07"
"2025-09-22T13:34:02.437Z","pro-free-trial","auto","No","1603","0","153378","655","155636","0.04"
"2025-09-22T13:30:49.311Z","pro-free-trial","auto","No","1528","0","301178","757","303463","0.08"
"2025-09-22T13:28:20.055Z","pro-free-trial","auto","No","1027","0","148159","451","149637","0.04"
"2025-09-22T13:24:15.782Z","pro-free-trial","auto","No","1214","0","145961","421","147596","0.04"
"2025-09-22T13:16:25.322Z","pro-free-trial","auto","No","10338","0","199933","5782","216053","0.10"
"2025-09-22T13:14:16.315Z","pro-free-trial","auto","No","241","0","62120","118","62479","0.02"
"2025-09-22T13:12:15.418Z","pro-free-trial","auto","No","715","0","123023","247","123985","0.03"
"2025-09-22T13:11:05.437Z","pro-free-trial","auto","No","745","0","121574","242","122561","0.03"
"2025-09-22T13:10:05.656Z","pro-free-trial","auto","No","861","0","119945","304","121110","0.03"
"2025-09-22T13:08:34.647Z","pro-free-trial","auto","No","1811","0","116934","695","119440","0.04"
"2025-09-22T13:05:43.551Z","pro-free-trial","auto","No","1423","0","228152","686","230261","0.06"
"2025-09-22T13:02:57.739Z","pro-free-trial","auto","No","1416","39427","111233","930","153006","0.08"
"2025-09-22T13:01:06.074Z","pro-free-trial","auto","No","3400","0","372482","912","376794","0.10"
"2025-09-22T12:59:54.798Z","pro-free-trial","auto","No","346","0","51425","250","52021","0.01"
"2025-09-22T12:57:46.039Z","pro-free-trial","auto","No","2253","0","150212","782","153247","0.05"
"2025-09-22T12:53:40.454Z","pro-free-trial","auto","No","3840","0","379037","1157","384034","0.11"
"2025-09-22T12:51:26.199Z","pro-free-trial","auto","No","1965","0","132414","693","135072","0.04"
"2025-09-22T12:48:38.605Z","pro-free-trial","auto","No","1383","0","127091","705","129179","0.04"
"2025-09-22T12:46:35.036Z","pro-free-trial","auto","No","1637","0","163730","622","165989","0.05"
"2025-09-22T12:44:44.916Z","pro-free-trial","auto","No","2155","30973","157168","1051","191347","0.09"
"2025-09-22T12:42:29.106Z","pro-free-trial","auto","No","2390","0","110542","755","113687","0.04"
"2025-09-22T12:39:27.422Z","pro-free-trial","auto","No","2543","0","172158","639","175340","0.05"
"2025-09-22T12:38:04.110Z","pro-free-trial","auto","No","26184","0","39978","311","66473","0.04"
"2025-09-22T12:34:10.590Z","pro-free-trial","auto","No","24040","88560","105818","25481","243899","0.32"
"2025-09-22T12:31:47.163Z","pro-free-trial","auto","No","2042","0","347353","733","350128","0.09"
"2025-09-22T12:29:00.725Z","pro-free-trial","auto","No","1414","0","341868","724","344006","0.09"
"2025-09-22T12:27:47.754Z","pro-free-trial","auto","No","295","0","113293","242","113830","0.03"
"2025-09-22T12:26:19.559Z","pro-free-trial","auto","No","1489","0","336654","804","338947","0.09"
"2025-09-22T12:25:11.591Z","pro-free-trial","auto","No","2199","0","331539","772","334510","0.09"
"2025-09-22T12:23:39.535Z","pro-free-trial","auto","No","1652","0","217106","503","219261","0.06"
"2025-09-22T12:21:17.577Z","pro-free-trial","auto","No","3168","1979","424043","1956","431146","0.12"
"2025-09-22T12:19:27.204Z","pro-free-trial","auto","No","3055","0","515032","1278","519365","0.14"
"2025-09-22T12:17:18.407Z","pro-free-trial","auto","No","637","0","202474","269","203380","0.05"
"2025-09-22T12:16:29.422Z","pro-free-trial","auto","No","938","0","200903","378","202219","0.05"
"2025-09-22T12:14:30.743Z","pro-free-trial","auto","No","891","0","198860","518","200269","0.05"
"2025-09-22T12:12:44.519Z","pro-free-trial","auto","No","869","0","197184","430","198483","0.05"
"2025-09-22T12:11:45.253Z","pro-free-trial","auto","No","920","0","195342","559","196821","0.05"
"2025-09-22T12:10:22.433Z","pro-free-trial","auto","No","1851","0","192564","513","194928","0.05"
"2025-09-22T12:06:29.263Z","pro-free-trial","auto","No","2214","0","283206","795","286215","0.08"
"2025-09-22T12:04:02.735Z","pro-free-trial","auto","No","1619","0","184766","373","186758","0.05"
"2025-09-22T12:02:48.081Z","pro-free-trial","auto","No","1286","1995","181920","899","186100","0.05"
"2025-09-22T12:00:34.205Z","pro-free-trial","auto","No","1572","1976","268888","1065","273501","0.08"
"2025-09-22T11:59:16.552Z","pro-free-trial","auto","No","1024","0","176239","543","177806","0.05"
"2025-09-22T11:57:37.012Z","pro-free-trial","auto","No","1263","0","173712","727","175702","0.05"
"2025-09-22T11:56:14.482Z","pro-free-trial","auto","No","1964","0","170524","704","173192","0.05"
"2025-09-22T11:54:36.415Z","pro-free-trial","auto","No","1979","0","166612","639","169230","0.05"
"2025-09-22T11:52:28.486Z","pro-free-trial","auto","No","2514","44020","325413","1595","373542","0.15"
"2025-09-22T11:51:24.928Z","pro-free-trial","auto","No","1786","0","157964","603","160353","0.05"
"2025-09-22T11:49:00.723Z","pro-free-trial","auto","No","1780","0","154548","499","156827","0.04"
"2025-09-22T11:47:00.114Z","pro-free-trial","auto","No","1042","0","151621","642","153305","0.04"
"2025-09-22T11:44:53.147Z","pro-free-trial","auto","No","1458","0","149391","463","151312","0.04"
"2025-09-22T11:43:12.641Z","pro-free-trial","auto","No","1381","0","146558","414","148353","0.04"
"2025-09-22T11:41:52.125Z","pro-free-trial","auto","No","2390","39540","142496","1371","185797","0.10"
"2025-09-22T11:39:34.647Z","pro-free-trial","auto","No","1539","0","207589","881","210009","0.06"
"2025-09-22T11:37:40.453Z","pro-free-trial","auto","No","61771","0","74418","1051","137240","0.10"
"2025-09-22T11:35:51.649Z","pro-free-trial","auto","No","4263","36426","323243","2156","366088","0.14"
"2025-09-22T11:33:30.476Z","pro-free-trial","auto","No","6191","0","527727","2713","536631","0.16"
"2025-09-22T11:26:57.703Z","pro-free-trial","auto","No","11547","0","245635","4302","261484","0.10"
"2025-09-22T11:25:20.145Z","pro-free-trial","auto","No","5196","0","207897","1351","214444","0.07"
"2025-09-22T11:23:52.670Z","pro-free-trial","auto","No","723","0","78238","279","79240","0.02"
"2025-09-22T11:23:11.209Z","pro-free-trial","auto","No","1116","0","114692","543","116351","0.03"
"2025-09-22T11:21:13.365Z","pro-free-trial","auto","No","1439","0","73259","719","75417","0.02"
"2025-09-22T11:17:03.440Z","Errored, Not Charged","auto","No","28648","0","42718","1194","72560","0.05"
"2025-09-22T11:14:20.047Z","pro-free-trial","auto","No","5266","0","346595","814","352675","0.10"
"2025-09-22T11:10:11.274Z","pro-free-trial","auto","No","2122","0","333875","977","336974","0.09"
"2025-09-22T11:06:02.015Z","pro-free-trial","auto","No","2382","0","327029","1092","330503","0.09"
"2025-09-22T11:01:30.221Z","pro-free-trial","auto","No","1659","0","214053","510","216222","0.06"
"2025-09-22T10:57:36.398Z","pro-free-trial","auto","No","6897","0","409309","1547","417753","0.12"
"2025-09-22T10:52:19.550Z","pro-free-trial","auto","No","2412","0","293700","1187","297299","0.08"
"2025-09-22T10:45:15.271Z","pro-free-trial","auto","No","1895","0","287582","903","290380","0.08"
"2025-09-22T10:39:45.882Z","pro-free-trial","auto","No","8036","0","271793","2561","282390","0.09"
"2025-09-22T10:37:39.567Z","pro-free-trial","auto","No","164","0","87175","281","87620","0.02"
"2025-09-22T10:36:44.346Z","pro-free-trial","auto","No","80067","0","94194","213","174474","0.12"
"2025-09-22T10:11:34.686Z","pro-free-trial","auto","No","17320","0","1133807","9968","1161095","0.36"
"2025-09-22T10:00:57.189Z","Errored, Not Charged","auto","No","4907","0","261584","7639","274130","0.12"
"2025-09-22T09:58:57.074Z","pro-free-trial","auto","No","6040","0","121590","790","128420","0.04"
"2025-09-22T09:52:58.851Z","pro-free-trial","auto","No","18390","0","204324","869","223583","0.08"
"2025-09-22T09:48:33.069Z","pro-free-trial","auto","No","9593","0","262222","5453","277268","0.11"
"2025-09-22T09:46:33.247Z","pro-free-trial","auto","No","363","0","39045","340","39748","0.01"
"2025-09-22T09:45:42.889Z","pro-free-trial","auto","No","1166","16688","37880","1120","56854","0.04"
"2025-09-22T09:43:59.789Z","pro-free-trial","auto","No","4493","0","67842","2413","74748","0.04"
"2025-09-22T09:42:09.798Z","pro-free-trial","auto","No","372","0","33018","295","33685","0.01"
"2025-09-22T09:41:27.812Z","pro-free-trial","auto","No","1020","0","31999","356","33375","0.01"
"2025-09-22T09:38:13.728Z","pro-free-trial","auto","No","2441","14412","60409","1759","79021","0.05"
"2025-09-22T09:36:10.459Z","pro-free-trial","auto","No","3615","13149","164654","1825","183243","0.07"
"2025-09-22T09:33:37.980Z","pro-free-trial","auto","No","4744","0","69172","1542","75458","0.03"
"2025-09-22T09:30:10.985Z","pro-free-trial","auto","No","2445","0","39227","721","42393","0.02"
"2025-09-22T09:27:27.015Z","pro-free-trial","auto","No","21369","98349","50284","7367","177369","0.21"
"2025-09-22T09:25:39.069Z","pro-free-trial","auto","No","1490","0","230444","739","232673","0.06"
"2025-09-22T09:23:15.101Z","pro-free-trial","auto","No","1043","0","228373","615","230031","0.06"
"2025-09-22T09:21:24.888Z","pro-free-trial","auto","No","974","1988","113049","881","116892","0.04"
"2025-09-22T09:14:22.594Z","pro-free-trial","auto","No","3825","0","109225","335","113385","0.03"
"2025-09-22T09:11:14.118Z","pro-free-trial","auto","No","326","0","108900","271","109497","0.03"
"2025-09-22T09:02:00.662Z","pro-free-trial","auto","No","293","0","108608","298","109199","0.03"
"2025-09-22T08:51:57.335Z","pro-free-trial","auto","No","338","0","108271","269","108878","0.03"
"2025-09-22T08:50:26.485Z","pro-free-trial","auto","No","328","0","107944","288","108560","0.03"
"2025-09-22T08:43:43.808Z","pro-free-trial","auto","No","331","0","107614","298","108243","0.03"
"2025-09-22T08:41:57.072Z","pro-free-trial","auto","No","344","0","107271","300","107915","0.03"
"2025-09-22T08:39:00.838Z","pro-free-trial","auto","No","325","0","106947","304","107576","0.03"
"2025-09-22T08:38:16.479Z","pro-free-trial","auto","No","296","0","106652","300","107248","0.03"
"2025-09-22T08:37:17.002Z","pro-free-trial","auto","No","281","0","106372","266","106919","0.03"
"2025-09-22T08:35:48.802Z","pro-free-trial","auto","No","290","0","106083","247","106620","0.03"
"2025-09-22T08:34:09.290Z","pro-free-trial","auto","No","262","0","105822","244","106328","0.03"
"2025-09-22T08:33:22.535Z","pro-free-trial","auto","No","299","0","105524","242","106065","0.03"
"2025-09-22T08:32:20.297Z","pro-free-trial","auto","No","277","0","105248","275","105800","0.03"
"2025-09-22T08:31:46.112Z","pro-free-trial","auto","No","305","0","104944","261","105510","0.03"
"2025-09-22T08:31:07.371Z","pro-free-trial","auto","No","413","0","104532","281","105226","0.03"
"2025-09-22T08:29:33.298Z","pro-free-trial","auto","No","373","0","104160","384","104917","0.03"
"2025-09-22T08:28:27.296Z","pro-free-trial","auto","No","358","0","103803","325","104486","0.03"
"2025-09-22T08:26:48.968Z","pro-free-trial","auto","No","96698","0","7106","318","104122","0.12"
"2025-09-22T08:19:34.115Z","pro-free-trial","auto","No","266","0","103171","299","103736","0.03"
"2025-09-22T08:18:35.728Z","pro-free-trial","auto","No","248","0","102924","234","103406","0.03"
"2025-09-22T08:17:40.043Z","pro-free-trial","auto","No","534","0","205078","238","205850","0.05"
"2025-09-22T08:15:54.917Z","pro-free-trial","auto","No","560","0","203925","347","204832","0.05"
"2025-09-22T08:14:30.223Z","pro-free-trial","auto","No","294","0","101541","200","102035","0.03"
"2025-09-22T08:13:07.617Z","pro-free-trial","auto","No","194","0","101348","273","101815","0.03"
"2025-09-22T08:12:17.792Z","pro-free-trial","auto","No","505","0","201912","227","202644","0.05"
"2025-09-22T08:11:20.925Z","pro-free-trial","auto","No","1365","0","200017","294","201676","0.05"
"2025-09-22T08:08:45.875Z","pro-free-trial","auto","No","2250","0","594186","1094","597530","0.16"
"2025-09-22T08:06:17.699Z","pro-free-trial","auto","No","3969","0","673729","1285","678983","0.18"
"2025-09-22T08:01:15.753Z","pro-free-trial","auto","No","5362","0","1093342","2639","1101343","0.30"
"2025-09-22T07:58:42.293Z","pro-free-trial","auto","No","2048","0","349869","662","352579","0.09"
"2025-09-22T07:56:54.984Z","pro-free-trial","auto","No","1280","0","171128","741","173149","0.05"
"2025-09-22T07:53:53.720Z","pro-free-trial","auto","No","2095","0","167798","692","170585","0.05"
"2025-09-22T07:52:06.081Z","pro-free-trial","auto","No","77397","0","90496","319","168212","0.12"
"2025-09-22T07:49:42.354Z","pro-free-trial","auto","No","2396","0","326817","1162","330375","0.09"
"2025-09-22T07:45:28.932Z","pro-free-trial","auto","No","1528","0","159024","867","161419","0.05"
"2025-09-22T07:44:33.176Z","pro-free-trial","auto","No","1057","0","236200","405","237662","0.06"
"2025-09-22T07:40:38.149Z","pro-free-trial","auto","No","3401","0","381332","1812","386545","0.11"
"2025-09-22T07:38:44.410Z","pro-free-trial","auto","No","1107","0","297013","607","298727","0.08"
"2025-09-22T07:37:40.852Z","pro-free-trial","auto","No","1446","0","145838","235","147519","0.04"
"2025-09-22T07:36:35.345Z","pro-free-trial","auto","No","1492","0","142733","420","144645","0.04"
"2025-09-22T07:34:27.636Z","pro-free-trial","auto","No","2146","0","278533","755","281434","0.08"
"2025-09-22T07:32:22.448Z","pro-free-trial","auto","No","1709","0","134854","687","137250","0.04"
"2025-09-22T07:29:49.647Z","pro-free-trial","auto","No","851","0","66165","426","67442","0.02"
"2025-09-22T07:26:41.122Z","pro-free-trial","auto","No","5655","0","251813","1036","258504","0.08"
"2025-09-22T07:24:38.566Z","pro-free-trial","auto","No","53406","0","67516","204","121126","0.08"
"2025-09-21T20:25:10.240Z","pro-free-trial","auto","No","3528","0","464701","1359","469588","0.13"
"2025-09-21T20:22:53.353Z","pro-free-trial","auto","No","2362","0","275025","977","278364","0.08"
"2025-09-21T20:21:08.376Z","pro-free-trial","auto","No","1185","0","159590","627","161402","0.05"
"2025-09-21T20:19:52.471Z","pro-free-trial","auto","No","446","0","105197","320","105963","0.03"
"2025-09-21T20:18:24.260Z","pro-free-trial","auto","No","324","0","52157","223","52704","0.01"
"2025-09-21T20:16:56.609Z","pro-free-trial","auto","No","325","0","51833","306","52464","0.02"
"2025-09-21T20:15:02.998Z","pro-free-trial","auto","No","796","0","102367","445","103608","0.03"
"2025-09-21T20:14:13.579Z","pro-free-trial","auto","No","372","0","101515","324","102211","0.03"
"2025-09-21T20:11:57.980Z","pro-free-trial","auto","No","507","0","100525","171","101203","0.03"
"2025-09-21T20:08:10.033Z","pro-free-trial","auto","No","687","0","99175","297","100159","0.03"
"2025-09-21T20:06:32.579Z","pro-free-trial","auto","No","540","0","98108","203","98851","0.03"
"2025-09-21T20:05:56.531Z","pro-free-trial","auto","No","570","0","97017","261","97848","0.03"
"2025-09-21T20:00:22.906Z","pro-free-trial","auto","No","666","0","95722","303","96691","0.03"
"2025-09-21T19:58:43.738Z","pro-free-trial","auto","No","923","0","141188","391","142502","0.04"
"2025-09-21T19:55:53.266Z","pro-free-trial","auto","No","1095","0","137928","503","139526","0.04"
"2025-09-21T19:54:29.763Z","pro-free-trial","auto","No","3958","0","83708","384","88050","0.03"
"2025-09-21T19:52:37.429Z","pro-free-trial","auto","No","958","0","81804","431","83193","0.02"
"2025-09-21T19:49:45.904Z","pro-free-trial","auto","No","1166","0","79683","450","81299","0.02"
"2025-09-21T19:48:28.076Z","pro-free-trial","auto","No","5017","0","108648","707","114372","0.04"
"2025-09-21T19:43:47.180Z","pro-free-trial","auto","No","3716","0","261935","1844","267495","0.08"
"2025-09-21T19:40:33.218Z","pro-free-trial","auto","No","766","0","60912","271","61949","0.02"
"2025-09-21T19:36:52.220Z","pro-free-trial","auto","No","23050","0","528688","7428","559166","0.21"
"2025-09-21T19:32:31.254Z","pro-free-trial","auto","No","1429","0","21933","370","23732","0.01"
"2025-09-21T17:54:27.217Z","pro-free-trial","auto","No","21076","0","2420461","4231","2445768","0.66"
"2025-09-21T17:48:29.417Z","pro-free-trial","auto","No","77245","718","765390","3343","846696","0.31"
"2025-09-21T17:38:14.645Z","pro-free-trial","auto","No","19198","0","1549599","5402","1574199","0.44"
"2025-09-21T17:27:17.593Z","pro-free-trial","auto","No","42363","114645","580841","13073","750922","0.42"
"2025-09-21T17:16:19.523Z","pro-free-trial","auto","No","98614","0","2485465","6388","2590467","0.78"
"2025-09-21T17:04:38.267Z","pro-free-trial","auto","No","21028","0","1888007","2126","1911161","0.51"
"2025-09-21T16:58:34.030Z","pro-free-trial","auto","No","12285","0","1185946","2018","1200249","0.32"
"2025-09-21T16:51:05.915Z","Errored, Not Charged","auto","No","10184","0","622557","1078","633819","0.17"
"2025-09-21T16:50:00.297Z","pro-free-trial","auto","No","12748","0","248460","571","261779","0.08"
"2025-09-21T16:46:50.999Z","pro-free-trial","auto","No","65093","98169","335532","12093","510887","0.36"
"2025-09-21T16:42:36.502Z","pro-free-trial","auto","No","12465","0","979325","1660","993450","0.27"
"2025-09-21T16:35:07.619Z","pro-free-trial","auto","No","14239","0","1820914","2055","1837208","0.49"
"2025-09-21T16:29:37.231Z","pro-free-trial","auto","No","24173","0","1491229","2902","1518304","0.42"
"2025-09-21T16:26:10.592Z","pro-free-trial","auto","No","6847","0","172888","981","180716","0.06"
"2025-09-21T16:19:30.317Z","pro-free-trial","auto","No","17849","0","1011307","1925","1031081","0.29"
"2025-09-21T16:13:35.739Z","pro-free-trial","auto","No","7933","0","94846","775","103554","0.04"
"2025-09-21T16:06:54.076Z","pro-free-trial","auto","No","21115","309717","171347","5256","507435","0.49"
"2025-09-21T15:55:37.852Z","pro-free-trial","auto","No","7524","0","335075","298","342897","0.09"
"2025-09-21T15:48:08.419Z","pro-free-trial","auto","No","56833","0","177939","308","235080","0.12"
"2025-09-21T15:45:16.218Z","pro-free-trial","auto","No","799","0","55450","312","56561","0.02"
"2025-09-21T15:37:23.946Z","pro-free-trial","auto","No","25213","0","195956","189","221358","0.08"
"2025-09-21T15:16:52.939Z","pro-free-trial","auto","No","25706","0","1773077","8490","1807273","0.53"
"2025-09-21T15:13:30.475Z","pro-free-trial","auto","No","21999","307117","7110","3649","339875","0.44"
"2025-09-21T14:44:51.184Z","pro-free-trial","auto","No","46796","87266","648549","15506","798117","0.42"
"2025-09-21T14:34:50.789Z","pro-free-trial","auto","No","14730","0","831638","1030","847398","0.23"
"2025-09-21T14:24:50.864Z","pro-free-trial","auto","No","84712","0","1623009","1847","1709568","0.52"
"2025-09-21T13:59:49.065Z","pro-free-trial","auto","No","93170","65858","2562331","24720","2746079","0.99"
"2025-09-21T13:43:49.186Z","pro-free-trial","auto","No","88392","0","1931680","3463","2023535","0.61"
"2025-09-21T10:30:18.135Z","pro-free-trial","auto","No","64997","90072","787765","21553","964387","0.52"
"2025-09-21T10:15:33.460Z","pro-free-trial","auto","No","109812","47653","2254071","26567","2438103","0.92"
"2025-09-21T09:54:09.850Z","pro-free-trial","auto","No","103714","95637","5349706","26648","5575705","1.75"
"2025-09-21T09:46:58.090Z","pro-free-trial","auto","No","23177","87","571171","892","595327","0.18"
"2025-09-21T09:43:32.976Z","pro-free-trial","auto","No","87630","0","1300803","1931","1390364","0.45"
"2025-09-21T09:32:05.834Z","pro-free-trial","auto","No","64912","81560","1620078","19316","1785866","0.70"
"2025-09-21T09:25:06.804Z","pro-free-trial","auto","No","32842","0","703848","5616","742306","0.25"
"2025-09-21T09:18:21.449Z","pro-free-trial","auto","No","22847","594","816705","6419","846565","0.27"
"2025-09-21T09:13:55.306Z","pro-free-trial","auto","No","53703","72862","396301","15565","538431","0.35"
"2025-09-21T09:08:47.340Z","pro-free-trial","auto","No","25649","1587","2633571","4265","2665072","0.72"
"2025-09-21T09:04:29.439Z","pro-free-trial","auto","No","50852","20577","995384","3683","1070496","0.36"
"2025-09-21T08:54:45.430Z","pro-free-trial","auto","No","14516","0","880273","2433","897222","0.25"
"2025-09-21T08:47:47.687Z","pro-free-trial","auto","No","10562","0","573851","1929","586342","0.17"
"2025-09-21T08:39:17.382Z","pro-free-trial","auto","No","27267","288585","75574","8165","399591","0.46"
"2025-09-21T08:09:24.640Z","pro-free-trial","auto","No","60407","80720","1378906","27960","1547993","0.69"
"2025-09-21T07:30:55.267Z","pro-free-trial","auto","No","99787","0","2308103","6849","2414739","0.74"
"2025-09-21T00:51:48.500Z","pro-free-trial","auto","No","12024","0","752962","2907","767893","0.22"
"2025-09-21T00:46:06.645Z","pro-free-trial","auto","No","68338","62246","305907","20878","457369","0.36"
"2025-09-21T00:09:22.597Z","pro-free-trial","auto","No","212051","50254","3184197","28399","3474901","1.29"
"2025-09-20T23:49:57.640Z","pro-free-trial","auto","No","139041","44455","3285247","35147","3503890","1.26"
"2025-09-20T23:39:07.865Z","pro-free-trial","auto","No","30087","0","1455881","6482","1492450","0.44"
"2025-09-20T23:35:46.665Z","pro-free-trial","auto","No","40696","103107","146004","18568","308375","0.33"
"2025-09-20T23:29:51.351Z","pro-free-trial","auto","No","10122","0","101172","190","111484","0.04"
"2025-09-20T23:23:30.863Z","pro-free-trial","auto","No","105051","0","1573947","1830","1680828","0.54"
"2025-09-20T23:21:16.815Z","pro-free-trial","auto","No","10933","0","331406","615","342954","0.10"
"2025-09-20T23:19:33.720Z","pro-free-trial","auto","No","9912","0","65218","200","75330","0.03"
"2025-09-20T23:18:03.368Z","pro-free-trial","auto","No","10408","0","54811","160","65379","0.03"
"2025-09-20T23:15:53.992Z","pro-free-trial","auto","No","12182","0","258433","1081","271696","0.09"
"2025-09-20T23:13:41.743Z","pro-free-trial","auto","No","35240","0","255255","1322","291817","0.12"
"2025-09-20T23:11:07.805Z","pro-free-trial","auto","No","10711","0","428214","513","439438","0.12"
"2025-09-20T23:09:21.252Z","pro-free-trial","auto","No","10350","0","287202","413","297965","0.09"
"2025-09-20T23:07:56.663Z","pro-free-trial","auto","No","10903","0","343347","446","354696","0.10"
"2025-09-20T23:06:18.215Z","pro-free-trial","auto","No","10759","0","223007","450","234216","0.07"
"2025-09-20T23:04:36.090Z","pro-free-trial","auto","No","11130","0","190371","448","201949","0.06"
"2025-09-20T23:03:09.837Z","pro-free-trial","auto","No","10831","0","157289","452","168572","0.06"
"2025-09-20T22:59:57.473Z","pro-free-trial","auto","No","38047","126241","97581","17421","279290","0.33"
"2025-09-20T22:56:52.602Z","pro-free-trial","auto","No","11592","0","464121","529","476242","0.13"
"2025-09-20T22:50:31.334Z","pro-free-trial","auto","No","11653","0","525021","547","537221","0.15"
"2025-09-20T22:45:09.276Z","pro-free-trial","auto","No","11914","0","560131","1033","573078","0.16"
"2025-09-20T22:39:06.103Z","pro-free-trial","auto","No","12976","0","403211","2433","418620","0.13"
"2025-09-20T22:33:53.102Z","pro-free-trial","auto","No","16768","0","334734","2322","353824","0.12"
"2025-09-20T22:21:11.257Z","pro-free-trial","auto","No","88388","0","628785","11006","728179","0.33"
"2025-09-20T22:18:45.684Z","pro-free-trial","auto","No","104229","0","227641","459","332329","0.19"
"2025-09-20T22:08:21.561Z","pro-free-trial","auto","No","18224","0","260873","300","279397","0.09"
"2025-09-20T22:02:47.966Z","pro-free-trial","auto","No","11855","0","851025","648","863528","0.23"
"2025-09-20T21:55:43.116Z","pro-free-trial","auto","No","14568","0","1037696","1387","1053651","0.29"
"2025-09-20T21:53:29.586Z","pro-free-trial","auto","No","10125","0","95669","346","106140","0.04"
"2025-09-20T21:41:37.192Z","pro-free-trial","auto","No","35391","68029","510285","12983","626688","0.33"
"2025-09-20T21:31:38.004Z","pro-free-trial","auto","No","16000","0","1261043","2393","1279436","0.35"
"2025-09-20T21:23:43.839Z","pro-free-trial","auto","No","80838","0","1128435","1870","1211143","0.39"
"2025-09-20T21:07:35.316Z","pro-free-trial","auto","No","11008","0","1925047","8218","1944273","0.54"
"2025-09-20T20:58:27.730Z","pro-free-trial","auto","No","62462","0","1976387","4023","2042872","0.60"
"2025-09-20T20:46:19.171Z","pro-free-trial","auto","No","13810","0","1063221","7319","1084350","0.33"
"2025-09-20T20:45:22.912Z","pro-free-trial","auto","No","1441","0","43458","382","45281","0.01"
"2025-09-20T20:42:29.706Z","pro-free-trial","auto","No","516","0","42943","162","43621","0.01"
"2025-09-20T20:39:02.262Z","pro-free-trial","auto","No","2849","0","80647","1739","85235","0.03"
"2025-09-20T20:37:27.803Z","pro-free-trial","auto","No","175","0","39922","362","40459","0.01"
"2025-09-20T20:35:44.667Z","pro-free-trial","auto","No","5822","0","146470","902","153194","0.05"
"2025-09-20T20:35:12.185Z","pro-free-trial","auto","No","1106","0","32999","430","34535","0.01"
"2025-09-20T20:27:31.525Z","pro-free-trial","auto","No","6626","0","345261","1315","353202","0.10"
"2025-09-20T20:22:30.801Z","pro-free-trial","auto","No","19282","263343","141096","7831","431552","0.44"
"2025-09-20T19:59:32.401Z","pro-free-trial","auto","No","85331","0","642978","1284","729593","0.28"
"2025-09-20T19:35:18.390Z","pro-free-trial","auto","No","50312","0","1540289","2703","1593304","0.46"
"2025-09-20T19:24:46.142Z","pro-free-trial","auto","No","73362","0","636494","1969","711825","0.26"
"2025-09-20T19:08:51.824Z","pro-free-trial","auto","No","99115","0","177325","6439","282879","0.21"
"2025-09-20T18:53:58.948Z","pro-free-trial","auto","No","153522","65073","15050","20105","253750","0.40"
"2025-09-20T18:13:43.350Z","pro-free-trial","auto","No","92020","0","2474537","13930","2580487","0.82"
"2025-09-20T17:44:18.259Z","pro-free-trial","auto","No","7832","0","649227","1387","658446","0.18"
"2025-09-20T17:35:02.893Z","pro-free-trial","auto","No","11501","0","928142","3120","942763","0.27"
"2025-09-20T17:25:14.451Z","pro-free-trial","auto","No","47931","0","1104787","4968","1157686","0.37"
"2025-09-20T17:09:17.482Z","pro-free-trial","auto","No","36669","0","501197","1856","539722","0.18"
"2025-09-20T17:05:40.638Z","pro-free-trial","auto","No","1985","0","147399","1096","150480","0.05"
"2025-09-20T17:02:35.771Z","pro-free-trial","auto","No","5181","0","253309","1213","259703","0.08"
"2025-09-20T16:59:49.514Z","pro-free-trial","auto","No","1691","0","28981","300","30972","0.01"
"2025-09-20T16:50:53.273Z","pro-free-trial","auto","No","21311","92904","172092","12861","299168","0.26"
"2025-09-20T16:41:50.405Z","pro-free-trial","auto","No","7452","0","1627358","1491","1636301","0.43"
"2025-09-20T16:39:29.842Z","pro-free-trial","auto","No","3297","0","512668","797","516762","0.14"
"2025-09-20T16:33:58.158Z","pro-free-trial","auto","No","4105","0","1095089","1476","1100670","0.29"
"2025-09-20T16:32:23.247Z","pro-free-trial","auto","No","688","0","194263","179","195130","0.05"
"2025-09-20T16:28:19.413Z","pro-free-trial","auto","No","4358","0","852747","1095","858200","0.23"
"2025-09-20T16:25:03.800Z","pro-free-trial","auto","No","2567","0","638080","1170","641817","0.17"
"2025-09-20T16:19:34.146Z","pro-free-trial","auto","No","4494","0","1051672","1891","1058057","0.28"
"2025-09-20T16:15:12.359Z","pro-free-trial","auto","No","2696","0","252195","549","255440","0.07"
"2025-09-20T16:08:44.318Z","pro-free-trial","auto","No","75708","0","1494170","2565","1572443","0.48"
"2025-09-20T16:02:21.069Z","pro-free-trial","auto","No","6933","0","1273212","2635","1282780","0.34"
"2025-09-20T15:56:13.298Z","pro-free-trial","auto","No","6870","0","1155234","2033","1164137","0.31"
"2025-09-20T15:54:13.246Z","pro-free-trial","auto","No","1826","0","178386","632","180844","0.05"
"2025-09-20T15:52:04.260Z","pro-free-trial","auto","No","2194","0","230191","478","232863","0.06"
"2025-09-20T15:50:07.742Z","pro-free-trial","auto","No","1679","0","166760","507","168946","0.05"
"2025-09-20T15:42:13.308Z","pro-free-trial","auto","No","7598","0","1215371","3245","1226214","0.33"
"2025-09-20T15:36:26.302Z","pro-free-trial","auto","No","6839","0","871657","2634","881130","0.24"
"2025-09-20T15:28:01.055Z","pro-free-trial","auto","No","10321","0","802021","3699","816041","0.24"
"2025-09-20T15:23:42.855Z","pro-free-trial","auto","No","4124","0","421931","1536","427591","0.12"
"2025-09-20T15:20:54.466Z","pro-free-trial","auto","No","18976","0","130199","844","150019","0.06"
"2025-09-20T15:12:21.754Z","pro-free-trial","auto","No","5301","0","222457","1705","229463","0.07"
"2025-09-20T15:06:58.435Z","pro-free-trial","auto","No","11167","268914","95438","4750","380269","0.40"
"2025-09-20T14:40:27.924Z","pro-free-trial","auto","No","5385","0","837942","1288","844615","0.22"
"2025-09-20T14:14:05.899Z","pro-free-trial","auto","No","57552","83866","4634420","14407","4790245","1.42"
"2025-09-20T14:11:57.431Z","pro-free-trial","auto","No","2186","0","94084","361","96631","0.03"
"2025-09-20T14:10:07.852Z","pro-free-trial","auto","No","3955","0","461823","941","466719","0.13"
"2025-09-20T14:02:46.525Z","pro-free-trial","auto","No","83039","0","1240799","1958","1325796","0.43"
"2025-09-20T13:46:53.715Z","pro-free-trial","auto","No","31616","0","1854408","8770","1894794","0.56"
"2025-09-20T13:42:26.590Z","pro-free-trial","auto","No","4200","0","147659","1120","152979","0.05"
"2025-09-20T13:37:16.385Z","pro-free-trial","auto","No","4729","0","134012","1425","140166","0.05"
"2025-09-20T13:34:23.719Z","pro-free-trial","auto","No","5180","0","119140","1677","125997","0.05"
"2025-09-20T13:30:59.080Z","pro-free-trial","auto","No","5437","0","102972","1881","110290","0.04"
"2025-09-20T13:27:04.513Z","pro-free-trial","auto","No","24221","91381","67651","9562","192815","0.22"
"2025-09-20T13:22:52.165Z","pro-free-trial","auto","No","11673","0","309214","2882","323769","0.11"
"2025-09-20T13:19:01.692Z","pro-free-trial","auto","No","8136","0","281152","834","290122","0.09"
"2025-09-20T13:11:17.281Z","pro-free-trial","auto","No","10058","0","252275","2073","264406","0.09"
"2025-09-20T13:02:35.777Z","pro-free-trial","auto","No","71809","0","162532","880","235221","0.14"
"2025-09-19T21:59:55.879Z","pro-free-trial","auto","No","7535","0","487254","1505","496294","0.14"
"2025-09-19T21:57:27.648Z","pro-free-trial","auto","No","6136","0","311406","1282","318824","0.09"
"2025-09-19T21:55:15.350Z","pro-free-trial","auto","No","3684","0","54939","415","59038","0.02"
"2025-09-19T21:51:54.940Z","pro-free-trial","auto","No","5941","0","210427","1218","217586","0.07"
"2025-09-19T21:49:59.282Z","pro-free-trial","auto","No","3615","0","45388","441","49444","0.02"
"2025-09-19T21:46:31.095Z","pro-free-trial","auto","No","6942","0","211509","1326","219777","0.07"
"2025-09-19T21:34:47.112Z","pro-free-trial","auto","No","8873","0","636078","2756","647707","0.19"
"2025-09-19T21:20:22.987Z","pro-free-trial","auto","No","13233","0","600847","6904","620984","0.21"
"2025-09-19T21:18:16.638Z","pro-free-trial","auto","No","9280","300897","23362","8303","341842","0.44"
"2025-09-19T20:58:34.218Z","pro-free-trial","auto","No","1497","0","209735","356","211588","0.06"
"2025-09-19T20:53:24.254Z","pro-free-trial","auto","No","436","0","207094","201","207731","0.05"
"2025-09-19T20:48:56.215Z","pro-free-trial","auto","No","3068","0","68776","85","71929","0.02"
"2025-09-19T20:38:34.904Z","pro-free-trial","auto","No","4199","0","474165","398","478762","0.13"
"2025-09-19T20:24:37.147Z","pro-free-trial","auto","No","14702","0","1112719","4970","1132391","0.33"
"2025-09-19T20:21:55.849Z","pro-free-trial","auto","No","42795","0","155391","692","198878","0.10"
"2025-09-19T20:12:57.147Z","pro-free-trial","auto","No","39329","0","99455","755","139539","0.08"
"2025-09-19T19:51:27.032Z","pro-free-trial","auto","No","11978","2110","1194272","7062","1215422","0.36"
"2025-09-19T19:46:34.759Z","pro-free-trial","auto","No","21588","105226","8000","13657","148471","0.24"
"2025-09-19T19:33:02.812Z","pro-free-trial","auto","No","106099","1377","1568416","3088","1678980","0.54"
"2025-09-19T13:16:35.111Z","pro-free-trial","auto","No","26148","0","2299296","3850","2329294","0.63"
"2025-09-19T13:04:13.830Z","pro-free-trial","auto","No","4449","0","376096","526","381071","0.10"
"2025-09-19T12:57:16.221Z","pro-free-trial","auto","No","20129","0","808064","4298","832491","0.25"
"2025-09-19T12:48:27.544Z","pro-free-trial","auto","No","64884","78910","1483136","17451","1644381","0.66"
"2025-09-19T12:36:30.221Z","pro-free-trial","auto","No","99409","0","538176","1394","638979","0.27"
"2025-09-19T12:03:31.519Z","pro-free-trial","auto","No","75130","59694","1361376","18618","1514818","0.62"
"2025-09-19T11:49:00.278Z","pro-free-trial","auto","No","32749","0","3081664","7687","3122100","0.86"
"2025-09-19T11:45:01.970Z","pro-free-trial","auto","No","51786","89536","120608","18312","280242","0.32"
"2025-09-19T11:40:57.949Z","pro-free-trial","auto","No","15943","0","789408","1573","806924","0.23"
"2025-09-19T11:38:42.458Z","pro-free-trial","auto","No","88986","15889","164952","1349","271176","0.18"
"2025-09-19T11:37:12.984Z","pro-free-trial","auto","No","13910","0","128480","1244","143634","0.06"
"2025-09-19T11:34:00.190Z","Errored, Not Charged","auto","No","51709","7104","173728","2424","234965","0.13"
"2025-09-19T11:27:48.177Z","pro-free-trial","auto","No","20400","0","1078976","3773","1103149","0.32"
"2025-09-19T11:09:49.163Z","pro-free-trial","auto","No","81155","0","606144","1835","689134","0.26"
"2025-09-19T08:33:01.666Z","pro-free-trial","auto","No","5308","0","623552","857","629717","0.17"
"2025-09-19T08:30:33.071Z","pro-free-trial","auto","No","2928","0","305536","522","308986","0.08"
"2025-09-19T08:19:21.809Z","pro-free-trial","auto","No","19441","0","1082944","2211","1104596","0.31"
"2025-09-19T08:10:26.404Z","pro-free-trial","auto","No","8111","0","636000","933","645044","0.17"
"2025-09-19T08:05:15.418Z","pro-free-trial","auto","No","3984","0","246624","538","251146","0.07"
"2025-09-19T07:45:29.621Z","pro-free-trial","auto","No","30015","0","2017920","6637","2054572","0.58"
"2025-09-19T07:38:40.576Z","Errored, Not Charged","auto","No","36008","0","450496","2690","489194","0.17"
"2025-09-19T07:28:36.566Z","pro-free-trial","auto","No","10797","0","2832256","5859","2848912","0.76"
"2025-09-19T07:22:39.111Z","pro-free-trial","auto","No","7107","0","1008384","2366","1017857","0.28"
"2025-09-19T07:16:46.213Z","pro-free-trial","auto","No","6912","0","1524320","2851","1534083","0.41"
"2025-09-19T07:10:46.922Z","pro-free-trial","auto","No","10018","0","1047968","4697","1062683","0.30"
"2025-09-19T07:05:53.449Z","pro-free-trial","auto","No","5382","0","398880","2001","406263","0.12"
"2025-09-19T07:03:56.786Z","pro-free-trial","auto","No","1339","0","154048","1525","156912","0.05"
"2025-09-19T07:01:44.585Z","pro-free-trial","auto","No","5108","0","222048","772","227928","0.07"
"2025-09-19T06:58:07.313Z","pro-free-trial","auto","No","7447","0","496512","3334","507293","0.15"
"2025-09-19T06:52:30.222Z","pro-free-trial","auto","No","9134","0","567904","2978","580016","0.17"
"2025-09-19T06:46:48.725Z","pro-free-trial","auto","No","7583","1035","803904","2122","814644","0.22"
"2025-09-19T06:43:25.879Z","pro-free-trial","auto","No","1017","0","108608","166","109791","0.03"
"2025-09-19T06:38:18.167Z","Errored, Not Charged","auto","No","6347","0","464672","808","471827","0.13"
"2025-09-19T06:32:43.228Z","pro-free-trial","auto","No","11578","0","704832","786","717196","0.20"
"2025-09-19T06:23:34.136Z","Errored, Not Charged","auto","No","37014","0","826752","1596","865362","0.26"
"2025-09-19T06:20:12.349Z","pro-free-trial","auto","No","8939","0","1510784","1491","1521214","0.40"
"2025-09-19T06:16:30.410Z","pro-free-trial","auto","No","9803","0","908576","1546","919925","0.25"
"2025-09-19T06:13:23.445Z","pro-free-trial","auto","No","3722","0","92768","387","96877","0.03"
"2025-09-19T06:09:43.567Z","pro-free-trial","auto","No","3985","0","556608","395","560988","0.15"
"2025-09-19T06:08:49.555Z","pro-free-trial","auto","No","83246","0","7104","284","90634","0.11"
"2025-09-18T22:02:58.769Z","pro-free-trial","auto","No","12759","0","1847328","2265","1862352","0.49"
"2025-09-18T21:59:03.174Z","pro-free-trial","auto","No","16268","0","767648","2420","786336","0.23"
"2025-09-18T21:56:38.056Z","pro-free-trial","auto","No","15743","0","567904","725","584372","0.17"
"2025-09-18T21:49:34.930Z","pro-free-trial","auto","No","11103","0","1098976","3602","1113681","0.31"
"2025-09-18T21:36:42.475Z","Errored, Not Charged","auto","No","75797","0","1618720","6717","1701234","0.54"
"2025-09-18T21:27:35.726Z","pro-free-trial","auto","No","44473","215513","393504","12982","666472","0.50"
"2025-09-18T20:35:03.140Z","pro-free-trial","auto","No","188849","0","3606944","3391","3799184","1.16"
"2025-09-18T20:29:09.891Z","pro-free-trial","auto","No","28722","0","1118048","7390","1154160","0.36"
"2025-09-18T20:24:27.014Z","pro-free-trial","auto","No","28327","0","649216","3001","680544","0.22"
"2025-09-18T20:17:33.638Z","pro-free-trial","auto","No","18320","0","1061568","2444","1082332","0.30"
"2025-09-18T20:09:45.331Z","pro-free-trial","auto","No","51528","0","953792","7893","1013213","0.35"
"2025-09-18T19:59:13.411Z","pro-free-trial","auto","No","48404","183320","137408","2874","372006","0.34"
"2025-09-18T18:10:30.049Z","pro-free-trial","auto","No","6888","0","490144","375","497407","0.13"
"2025-09-18T18:05:44.350Z","pro-free-trial","auto","No","29985","0","1226432","2061","1258478","0.36"
"2025-09-18T17:58:37.223Z","pro-free-trial","auto","No","82775","0","1168704","8313","1259792","0.45"
"2025-09-18T17:57:30.537Z","pro-free-trial","auto","No","818","0","14208","167","15193","0.01"
"2025-09-16T19:16:10.662Z","Errored, Not Charged","auto","No","178631","0","1537536","6720","1722887","0.65"
"2025-09-16T18:53:52.873Z","pro-free-trial","auto","No","95568","0","2415680","7644","2518892","0.77"
"2025-09-16T18:46:30.747Z","pro-free-trial","auto","No","109838","0","588832","2399","701069","0.30"
"2025-09-16T18:31:06.730Z","pro-free-trial","auto","No","102141","0","1989696","4672","2096509","0.65"
"2025-09-16T18:04:19.481Z","pro-free-trial","auto","No","32471","0","1112352","3550","1148373","0.34"
"2025-09-16T17:52:43.062Z","pro-free-trial","auto","No","89912","61419","437216","15972","604519","0.39"
"2025-09-16T17:31:32.175Z","pro-free-trial","auto","No","184967","0","1014272","609","1199848","0.49"
"2025-09-16T13:28:16.384Z","pro-free-trial","auto","No","186770","0","2946528","4407","3137705","1.00"
"2025-09-16T12:53:05.657Z","pro-free-trial","auto","No","121867","0","789952","2230","914049","0.36"
"2025-09-16T10:14:39.183Z","pro-free-trial","auto","No","67075","0","221440","783","289298","0.14"
"2025-09-16T09:50:18.811Z","pro-free-trial","auto","No","129380","50933","2481664","20963","2682940","0.97"
"2025-09-16T09:17:39.126Z","pro-free-trial","auto","No","196006","0","3676992","17852","3890850","1.27"
"2025-09-16T06:13:38.405Z","pro-free-trial","auto","No","80111","0","7104","698","87913","0.11"
"2025-09-16T05:32:40.470Z","pro-free-trial","auto","No","108314","0","3531104","16500","3655918","1.12"
"2025-09-16T05:24:22.995Z","pro-free-trial","auto","No","71357","0","585472","1052","657881","0.24"
"2025-09-15T21:54:03.561Z","pro-free-trial","auto","No","83149","0","2028384","22687","2134220","0.75"
"2025-09-15T21:51:39.304Z","pro-free-trial","auto","No","2329","0","7104","783","10216","0.01"
"2025-09-15T21:48:02.976Z","pro-free-trial","auto","No","1720","0","7104","559","9383","0.01"
"2025-09-15T21:40:38.138Z","pro-free-trial","auto","No","803","0","7104","764","8671","0.01"
"2025-09-15T21:34:11.799Z","pro-free-trial","auto","No","309","0","7104","87","7500","0.003"
"2025-09-15T20:30:37.998Z","pro-free-trial","auto","No","91841","29169","1430336","2248","1553594","0.52"
"2025-09-15T20:19:11.109Z","pro-free-trial","auto","No","22490","0","388128","395","411013","0.13"
"2025-09-15T20:13:45.471Z","pro-free-trial","auto","No","55146","0","707584","1131","763861","0.25"
"2025-09-15T20:06:17.350Z","pro-free-trial","auto","No","20174","0","358560","4435","383169","0.14"
"2025-09-15T20:05:24.226Z","pro-free-trial","auto","No","19240","23674","17728","1289","61931","0.07"
"2025-09-15T19:58:19.081Z","pro-free-trial","auto","No","36714","68665","139072","18702","263153","0.28"
"2025-09-15T19:54:55.045Z","pro-free-trial","auto","No","117140","0","1066464","1391","1184995","0.42"
"2025-09-15T19:31:49.053Z","pro-free-trial","auto","No","233421","30990","3685024","33422","3982857","1.45"
"2025-09-15T18:51:42.071Z","pro-free-trial","auto","No","202892","61172","3068192","30528","3362784","1.28"
"2025-09-15T18:30:41.985Z","pro-free-trial","auto","No","99498","0","3440832","13821","3554151","1.07"
"2025-09-15T17:55:43.851Z","pro-free-trial","auto","No","16472","0","59104","47","75623","0.04"
"2025-09-15T17:52:12.651Z","pro-free-trial","auto","No","18384","0","55744","931","75059","0.04"
"2025-09-15T17:46:58.149Z","pro-free-trial","auto","No","69723","0","783296","1900","854919","0.29"
"2025-09-15T17:19:51.142Z","pro-free-trial","auto","No","24809","0","818688","2325","845822","0.25"
"2025-09-15T17:16:38.588Z","pro-free-trial","auto","No","32720","0","457600","648","490968","0.16"
"2025-09-15T17:13:55.528Z","pro-free-trial","auto","No","2430","0","57760","351","60541","0.02"
"2025-09-15T17:12:11.093Z","pro-free-trial","auto","No","6761","0","582656","869","590286","0.16"
"2025-09-15T17:10:44.028Z","pro-free-trial","auto","No","26832","0","312672","337","339841","0.11"
"2025-09-15T17:07:54.898Z","pro-free-trial","auto","No","3561","0","107904","275","111740","0.03"
"2025-09-15T17:04:18.277Z","pro-free-trial","auto","No","22518","204","1058904","1702","1083328","0.30"
"2025-09-15T17:01:51.199Z","pro-free-trial","auto","No","41610","0","457216","1848","500674","0.18"
"2025-09-15T16:52:02.583Z","pro-free-trial","auto","No","41548","0","722656","9176","773380","0.29"
"2025-09-15T16:44:03.999Z","pro-free-trial","auto","No","20794","0","295264","4073","320131","0.12"
"2025-09-15T16:29:05.430Z","pro-free-trial","auto","No","18249","0","130560","1216","150025","0.06"
"2025-09-15T16:26:56.762Z","pro-free-trial","auto","No","640","0","8064","200","8904","0.004"
"2025-09-15T16:26:33.646Z","pro-free-trial","auto","No","847","0","22560","173","23580","0.01"
"2025-09-15T15:16:36.208Z","pro-free-trial","auto","No","102802","0","4246336","6039","4355177","1.23"
"2025-09-15T15:11:08.623Z","pro-free-trial","auto","No","27733","27801","574496","2973","633003","0.23"
"2025-09-15T15:08:45.788Z","pro-free-trial","auto","No","29661","26307","315936","2326","374230","0.16"
"2025-09-15T15:03:54.339Z","pro-free-trial","auto","No","36113","0","724640","2991","763744","0.24"
"2025-09-15T15:01:04.457Z","pro-free-trial","auto","No","25680","22333","319328","1781","369122","0.15"
"2025-09-15T14:56:34.547Z","pro-free-trial","auto","No","24350","0","401248","1493","427091","0.14"
"2025-09-15T14:54:12.971Z","pro-free-trial","auto","No","9831","0","41056","102","50989","0.02"
"2025-09-15T14:51:00.673Z","pro-free-trial","auto","No","45800","0","432736","2155","480691","0.16"
"2025-09-15T14:40:05.586Z","pro-free-trial","auto","No","58665","1172460","512672","24340","1768137","0.45"
"2025-09-15T14:13:43.830Z","pro-free-trial","auto","No","238188","38456","1429152","18399","1724195","0.67"
"2025-09-15T13:48:35.366Z","pro-free-trial","auto","No","174629","81160","4439200","26120","4721109","1.40"
"2025-09-15T13:19:42.702Z","Errored, Not Charged","auto","No","322891","178601","7715264","41277","8258033","2.43"
"2025-09-15T12:38:02.904Z","Errored, Not Charged","auto","No","217533","0","3356224","20265","3594022","1.14"
"2025-09-15T09:36:18.134Z","pro-free-trial","auto","No","152041","0","1612192","2743","1766976","0.57"
"2025-09-15T09:23:30.111Z","Errored, Not Charged","auto","No","61620","0","246368","298","308286","0.12"
"2025-09-15T09:16:19.215Z","Errored, Not Charged","auto","No","68957","0","3091392","5165","3165514","0.86"
"2025-09-15T09:10:50.296Z","pro-free-trial","auto","No","90144","0","691040","1446","782630","0.27"
"2025-09-15T08:57:28.013Z","pro-free-trial","auto","No","39046","0","798784","2773","840603","0.25"
"2025-09-15T08:51:18.798Z","Errored, Not Charged","auto","No","47948","27942","117472","914","194276","0.08"
"2025-09-15T08:48:24.016Z","pro-free-trial","auto","No","110998","200753","1328512","35909","1676172","0.60"
"2025-09-15T01:18:41.894Z","pro-free-trial","auto","No","28366","0","995200","805","1024371","0.28"
"2025-09-15T01:14:58.726Z","pro-free-trial","auto","No","74449","67283","88608","17455","247795","0.17"
"2025-09-15T00:55:35.652Z","pro-free-trial","auto","No","105493","144007","1783488","35194","2068182","0.70"
"2025-09-15T00:31:41.454Z","Errored, Not Charged","auto","No","204391","160918","4553184","47823","4966316","1.54"
"2025-09-15T00:14:52.287Z","pro-free-trial","auto","No","80002","72945","2785408","27531","2965886","0.89"
"2025-09-14T23:58:11.112Z","pro-free-trial","auto","No","88167","0","1323584","2315","1414066","0.43"
"2025-09-14T23:49:08.780Z","pro-free-trial","auto","No","43515","0","936512","2665","982692","0.29"
"2025-09-14T23:43:13.741Z","pro-free-trial","auto","No","46568","0","472224","2129","520921","0.17"
"2025-09-14T23:34:55.321Z","Errored, Not Charged","auto","No","23518","60251","1429376","8297","1521442","0.42"
"2025-09-14T23:29:47.296Z","pro-free-trial","auto","No","40260","0","1702528","2443","1745231","0.48"
"2025-09-14T23:21:52.359Z","pro-free-trial","auto","No","70099","0","858272","17490","945861","0.35"
"2025-09-14T23:13:50.505Z","pro-free-trial","auto","No","17064","0","492064","2604","511732","0.15"
"2025-09-14T23:06:44.499Z","pro-free-trial","auto","No","40850","0","755616","3065","799531","0.24"
"2025-09-14T22:36:33.450Z","Errored, Not Charged","auto","No","30540","0","454496","1913","486949","0.15"
"2025-09-14T22:09:48.539Z","pro-free-trial","auto","No","37173","0","1159040","4089","1200302","0.34"
"2025-09-14T22:00:54.290Z","pro-free-trial","auto","No","32121","87206","854080","12144","985551","0.30"
"2025-09-14T21:51:51.573Z","pro-free-trial","auto","No","107670","0","915488","3006","1026164","0.35"
"2025-09-14T21:41:40.346Z","pro-free-trial","auto","No","99125","0","1668096","4257","1771478","0.53"
"2025-09-14T21:28:14.226Z","pro-free-trial","auto","No","37231","0","2475776","16729","2529736","0.72"
"2025-09-14T21:23:09.412Z","pro-free-trial","auto","No","9780","0","113376","3047","126203","0.05"
"2025-09-14T21:19:56.099Z","pro-free-trial","auto","No","11396","3530","208096","846","223868","0.08"
"2025-09-14T21:14:47.740Z","pro-free-trial","auto","No","49405","0","1267744","4284","1321433","0.38"
"2025-09-14T20:56:13.749Z","pro-free-trial","auto","No","29120","0","7104","939","37163","0.03"
"2025-09-14T20:37:49.579Z","pro-free-trial","auto","No","22805","0","749792","3022","775619","0.22"
"2025-09-14T20:35:55.268Z","pro-free-trial","auto","No","11591","0","73376","809","85776","0.03"
"2025-09-14T20:34:33.798Z","pro-free-trial","auto","No","1936","0","14208","168","16312","0.01"
"2025-09-14T20:34:03.190Z","pro-free-trial","auto","No","314","0","7104","100","7518","0.002"
"2025-09-12T22:11:29.866Z","Errored, Not Charged","auto","No","32365","102679","7770","85","142899","0.05"
"2025-09-12T22:09:32.850Z","pro-free-trial","auto","No","16623","83221","617521","921","718286","0.19"
"2025-09-12T22:06:06.781Z","pro-free-trial","auto","No","2299","81042","669539","885","753765","0.19"
"2025-09-12T22:04:25.849Z","pro-free-trial","auto","No","2595","78375","556833","682","638485","0.16"
"2025-09-12T22:02:58.168Z","pro-free-trial","auto","No","572","77789","91370","470","170201","0.04"
"2025-09-12T21:59:47.674Z","pro-free-trial","auto","No","2339","79166","89032","1265","171802","0.04"
"2025-09-12T21:56:16.642Z","pro-free-trial","auto","No","1927","78713","87106","2434","170180","0.04"
"2025-09-12T21:54:17.896Z","pro-free-trial","auto","No","1358","73091","87377","1208","163034","0.04"
"2025-09-12T21:48:16.434Z","pro-free-trial","auto","No","2926","69085","1011701","3511","1087223","0.28"
"2025-09-12T21:46:12.576Z","pro-free-trial","auto","No","514","68553","82322","427","151816","0.03"
"2025-09-12T21:44:02.526Z","pro-free-trial","auto","No","1376","68007","80947","409","150739","0.03"
"2025-09-12T21:34:41.799Z","pro-free-trial","auto","No","2927","65614","480305","1551","550397","0.14"
"2025-09-12T21:29:57.930Z","pro-free-trial","auto","No","756","64785","156591","353","222485","0.05"
"2025-09-12T21:28:29.303Z","pro-free-trial","auto","No","713","64316","77362","342","142733","0.03"
"2025-09-12T21:23:18.653Z","pro-free-trial","auto","No","931","63527","154224","261","218943","0.05"
"2025-09-12T21:21:22.891Z","pro-free-trial","auto","No","69775","63032","7110","978","140895","0.08"
"2025-09-12T21:15:37.801Z","pro-free-trial","auto","No","1765","62158","264546","1724","330193","0.08"
"2025-09-12T21:13:15.164Z","pro-free-trial","auto","No","1906","98211","72879","975","173971","0.04"
"2025-09-12T21:10:45.909Z","pro-free-trial","auto","No","463","58830","72417","358","132068","0.03"
"2025-09-12T21:09:49.777Z","pro-free-trial","auto","No","1224","57741","287435","745","347145","0.08"
"2025-09-12T21:04:46.016Z","pro-free-trial","auto","No","5299","53056","1027463","1812","1087630","0.28"
"2025-09-12T20:59:14.911Z","pro-free-trial","auto","No","1125","52443","64789","1359","119716","0.03"
"2025-09-12T20:54:36.910Z","pro-free-trial","auto","No","1164","51301","63626","458","116549","0.03"
"2025-09-12T20:48:48.024Z","pro-free-trial","auto","No","847","0","62780","569","64196","0.02"
"2025-09-12T20:43:14.735Z","pro-free-trial","auto","No","545","0","62236","289","63070","0.02"
"2025-09-12T20:35:16.380Z","pro-free-trial","auto","No","2266","0","366670","1420","370356","0.10"
"2025-09-12T20:18:13.256Z","pro-free-trial","auto","No","52893","0","1432789","4097","1489779","0.43"
"2025-09-12T19:56:44.905Z","pro-free-trial","auto","No","2217","0","380234","654","383105","0.10"
"2025-09-12T19:53:08.274Z","pro-free-trial","auto","No","2781","0","224665","883","228329","0.06"
"2025-09-12T19:50:39.631Z","pro-free-trial","auto","No","6144","0","167173","552","173869","0.05"
"2025-09-12T19:42:32.214Z","pro-free-trial","auto","No","35390","0","355839","1601","392830","0.13"
"2025-09-12T19:23:03.793Z","pro-free-trial","auto","No","8736","0","707438","2781","718955","0.20"
"2025-09-12T19:11:57.944Z","pro-free-trial","auto","No","20431","104281","7112","13590","145414","0.09"
"2025-09-12T18:34:39.702Z","pro-free-trial","auto","No","7735","0","957581","5186","970502","0.27"
"2025-09-12T18:20:35.095Z","pro-free-trial","auto","No","1836","0","508049","870","510755","0.13"
"2025-09-12T18:13:08.831Z","pro-free-trial","auto","No","1838","0","498941","800","501579","0.13"
"2025-09-12T18:03:45.466Z","pro-free-trial","auto","No","2428","0","684005","984","687417","0.18"
"2025-09-12T17:57:13.285Z","pro-free-trial","auto","No","4771","0","1223942","1932","1230645","0.32"
"2025-09-12T17:44:22.047Z","pro-free-trial","auto","No","84674","0","1593760","3267","1681701","0.50"
"2025-09-12T14:17:30.229Z","pro-free-trial","auto","No","76560","0","7104","397","84061","0.08"
"2025-09-12T13:34:22.680Z","pro-free-trial","auto","No","90114","0","633408","1205","724727","0.25"
"2025-09-12T12:43:52.052Z","pro-free-trial","auto","No","68639","0","7104","1296","77039","0.08"
"2025-09-12T09:03:35.053Z","pro-free-trial","auto","No","46914","0","470112","1307","518333","0.17"
"2025-09-12T08:58:27.673Z","pro-free-trial","auto","No","69644","0","355968","962","426574","0.16"
"2025-09-12T08:43:18.312Z","pro-free-trial","auto","No","38639","0","237376","779","276794","0.10"
"2025-09-12T08:36:59.089Z","pro-free-trial","auto","No","75085","0","524256","1514","600855","0.21"
"2025-09-12T08:28:49.221Z","pro-free-trial","auto","No","17730","0","775232","2122","795084","0.22"
"2025-09-12T08:28:09.071Z","pro-free-trial","auto","No","49881","0","7104","481","57466","0.05"
"2025-09-12T08:20:30.141Z","pro-free-trial","auto","No","23456","0","737344","1880","762680","0.22"
"2025-09-12T08:18:45.488Z","pro-free-trial","auto","No","38528","0","8160","439","47127","0.04"
"2025-09-12T08:10:35.672Z","pro-free-trial","auto","No","99522","3464","801767","3605","908358","0.47"
"2025-09-12T08:01:06.322Z","pro-free-trial","auto","No","57750","103704","520992","9288","691734","0.24"
"2025-09-12T07:55:39.585Z","pro-free-trial","auto","No","113649","0","418432","832","532913","0.22"
"2025-09-12T07:47:22.947Z","pro-free-trial","auto","No","51987","0","451008","1244","504239","0.17"
"2025-09-12T07:41:59.972Z","pro-free-trial","auto","No","22151","0","454944","998","478093","0.14"
"2025-09-12T07:35:53.580Z","pro-free-trial","auto","No","47165","655","531286","1730","580836","0.18"
"2025-09-12T07:27:16.756Z","pro-free-trial","auto","No","54458","0","384256","866","439580","0.15"
"2025-09-12T07:24:30.869Z","pro-free-trial","auto","No","75490","0","7104","321","82915","0.08"
"2025-09-12T06:48:41.166Z","pro-free-trial","auto","No","83148","0","483552","886","567586","0.21"
"2025-09-12T06:31:19.758Z","pro-free-trial","auto","No","5001","0","74272","392","79665","0.03"
"2025-09-12T06:30:25.058Z","pro-free-trial","auto","No","71724","0","7104","354","79182","0.07"
"2025-09-11T23:40:50.151Z","pro-free-trial","auto","No","638","0","77576","411","78625","0.02"
"2025-09-11T23:39:17.337Z","pro-free-trial","auto","No","693","0","76884","421","77998","0.02"
"2025-09-11T23:34:54.801Z","pro-free-trial","auto","No","516","0","76369","451","77336","0.02"
"2025-09-11T23:31:08.635Z","pro-free-trial","auto","No","479","0","75891","406","76776","0.02"
"2025-09-11T23:28:05.661Z","pro-free-trial","auto","No","68782","0","7110","371","76263","0.07"
"2025-09-11T23:20:10.793Z","pro-free-trial","auto","No","994","0","149204","504","150702","0.04"
"2025-09-11T23:16:34.950Z","pro-free-trial","auto","No","831","0","73428","380","74639","0.02"
"2025-09-11T23:13:35.502Z","pro-free-trial","auto","No","4075","0","143207","407","147689","0.04"
"2025-09-11T23:11:01.429Z","pro-free-trial","auto","No","697","0","138639","369","139705","0.04"
"2025-09-11T23:09:36.730Z","pro-free-trial","auto","No","539","0","68560","315","69414","0.02"
"2025-09-11T23:05:33.481Z","pro-free-trial","auto","No","512","0","68049","387","68948","0.02"
"2025-09-11T23:04:15.029Z","pro-free-trial","auto","No","566","0","67484","326","68376","0.02"
"2025-09-11T23:02:44.403Z","pro-free-trial","auto","No","816","0","133903","418","135137","0.04"
"2025-09-11T22:59:30.464Z","pro-free-trial","auto","No","636","0","132447","420","133503","0.04"
"2025-09-11T22:56:04.174Z","pro-free-trial","auto","No","456","0","65581","234","66271","0.02"
"2025-09-11T22:54:51.925Z","pro-free-trial","auto","No","502","0","65080","319","65901","0.02"
"2025-09-11T22:50:47.960Z","pro-free-trial","auto","No","748","0","129143","461","130352","0.03"
"2025-09-11T22:47:29.783Z","pro-free-trial","auto","No","672","0","63663","338","64673","0.02"
"2025-09-11T22:43:11.663Z","pro-free-trial","auto","No","661","0","126440","713","127814","0.04"
"2025-09-11T22:41:12.656Z","pro-free-trial","auto","No","809","0","62196","303","63308","0.02"
"2025-09-11T22:35:33.919Z","pro-free-trial","auto","No","360","0","61837","386","62583","0.02"
"2025-09-11T22:28:54.766Z","pro-free-trial","auto","No","604","0","122809","373","123786","0.03"
"2025-09-11T22:26:54.299Z","pro-free-trial","auto","No","1995","0","239702","594","242291","0.06"
"2025-09-11T22:25:36.391Z","pro-free-trial","auto","No","52135","0","7110","535","59780","0.06"
"2025-09-11T22:21:20.411Z","pro-free-trial","auto","No","1684","0","172380","675","174739","0.05"
"2025-09-11T22:19:12.246Z","pro-free-trial","auto","No","541","0","56301","497","57339","0.02"
"2025-09-11T22:17:30.181Z","pro-free-trial","auto","No","420","0","55882","309","56611","0.02"
"2025-09-11T22:12:31.305Z","pro-free-trial","auto","No","1179","0","110088","350","111617","0.03"
"2025-09-11T22:07:16.503Z","pro-free-trial","auto","No","255","0","54451","532","55238","0.02"
"2025-09-11T22:06:13.535Z","pro-free-trial","auto","No","1439","0","160386","304","162129","0.04"
"2025-09-11T22:04:40.286Z","pro-free-trial","auto","No","4852","0","100777","283","105912","0.03"
"2025-09-11T22:00:22.001Z","pro-free-trial","auto","No","5703","0","689429","1849","696981","0.19"
"2025-09-11T21:59:08.002Z","pro-free-trial","auto","No","408","0","45861","297","46566","0.01"
"2025-09-11T21:56:31.795Z","pro-free-trial","auto","No","980","0","135830","537","137347","0.04"
"2025-09-11T21:52:04.906Z","pro-free-trial","auto","No","832","0","133103","764","134699","0.04"
"2025-09-11T21:43:55.508Z","pro-free-trial","auto","No","614","0","131302","185","132101","0.03"
"2025-09-11T21:39:00.204Z","pro-free-trial","auto","No","4510","0","451674","1833","458017","0.12"
"2025-09-11T21:37:34.195Z","pro-free-trial","auto","No","2448","0","227140","528","230116","0.06"
"2025-09-11T21:34:55.616Z","pro-free-trial","auto","No","3062","0","174210","612","177884","0.05"
"2025-09-11T21:28:18.944Z","pro-free-trial","auto","No","26686","0","380128","2108","408922","0.13"
"2025-09-11T21:26:49.880Z","pro-free-trial","auto","No","16","0","7172","49","7237","0.002"
"2025-09-11T21:24:27.130Z","pro-free-trial","auto","No","63","0","7110","62","7235","0.002"
"2025-09-06T20:54:54.220Z","free","auto","No","11656","0","1044576","2476","1058708","0.28"
"2025-09-06T20:50:09.698Z","free","auto","No","12745","0","885888","2087","900720","0.24"
"2025-09-06T20:46:35.951Z","free","auto","No","8805","925","779115","1956","790801","0.21"
"2025-09-06T20:44:31.010Z","free","auto","No","75109","0","977408","1674","1054191","0.33"
"2025-09-06T20:35:13.124Z","free","auto","No","71298","0","1135008","4055","1210361","0.37"
"2025-09-06T20:23:51.376Z","free","auto","No","134432","0","1457216","3984","1595632","0.51"
"2025-09-06T19:35:37.446Z","free","auto","No","51799","0","1051904","5503","1109206","0.34"
"2025-09-06T19:32:40.871Z","free","auto","No","23367","0","58688","776","82831","0.04"
